fiorella	fiorell
fiorello	fiorell
fiorent	fiorent
fiorenti	fiorent
fiorentin	fiorentin
fiorentina	fiorentin
fiorentini	fiorentin
fiorentino	fiorentin
fiorenza	fiorenz
fiorenzo	fiorenz
fioretti	fiorett
fioretto	fiorett
fiori	fiori
fioriai	fioriai
fiorini	fiorin
fiorino	fiorin
fiorir	fiorir
fioriranno	fioriranno
fiorirà	fiorir
fiorisc	fiorisc
fioriscano	fioriscano
fioriscono	fioriscono
fiorista	fiorist
fioristi	fiorist
fiorit	fiorit
fiorita	fiorit
fioriti	fiorit
fiorito	fiorit
fioritura	fioritura
fioriva	fioriva
fiornini	fiornini
fiorno	fiorno
fiorucci	fiorucci
fiorì	fiorì
fiotti	fiotti
fioux	fioux
fipe	fipe
fiplv	fiplv
fipo	fipo
fipoi	fipoi
fipresci	fipresci
fir	fir
fira	fira
firan	firan
firash	firash
firat	firat
fire	fire
firearm	firearm
firent	firen
firenz	firen
firepow	firepow
firiz	firiz
firm	firm
firma	firma
firmamento	firmamento
firmando	firmando
firmandon	firmando
firmano	firmano
firmar	firmar
firmarla	firmarl
firmarli	firmarl
firmarlo	firmarl
firmarn	firmar
firmarono	firmarono
firmarsi	firmarsi
firmass	firmass
firmassero	firmassero
firmassimo	firmassimo
firmat	firmat
firmata	firmat
firmatari	firmatari
firmataria	firmatari
firmatario	firmatari
firmati	firmat
firmato	firmat
firmava	firmav
firmavano	firmavano
firmavo	firmav
firmenich	firmenich
firmera	firmer
firmeranno	firmeranno
firmerano	firmerano
firmerebb	firmerebb
firmerei	firmerei
firmeremo	firmeremo
firmerà	firmer
firmerò	firmer
firmi	firmi
firmiamo	firmiamo
firmin	firmin
firmino	firmin
firmo	firmo
firmò	firmò
firouz	firouz
firouzabad	firouzabad
firoza	firoza
firpo	firpo
firrao	firrao
firsec	firsec
first	first
firt	firt
firuzabad	firuzabad
fisali	fisali
fisarmonica	fisarmonica
fisarmonicist	fisarmonicist
fisca	fisca
fiscal	fiscal
fiscali	fiscal
fiscalismi	fiscalismi
fiscalità	fiscalità
fiscalizzazion	fiscalizzazion
fiscalment	fiscalment
fischbach	fischbach
fischent	fischent
fischenth	fischent
fischer	fischer
fischi	fischi
fischiando	fischiando
fischiar	fischiar
fischiati	fischiat
fischiato	fischiat
fischiatori	fischiatori
fischiava	fischiava
fischietti	fischietti
fischingen	fischingen
fischio	fischi
fischler	fischler
fiscmr	fiscmr
fisco	fisco
fiscxali	fiscxali
fish	fish
fishberg	fishberg
fishburn	fishburn
fisher	fisher
fisheri	fisher
fishtal	fishtal
fisiatri	fisiatri
fisic	fisic
fisica	fisic
fisicamanté	fisicamanté
fisicament	fisicament
fisich	fisich
fisicha	fisich
fisichella	fisichella
fisici	fisic
fisico	fisic
fisicà	fisic
fisiologia	fisiologia
fisiologica	fisiologic
fisiologicament	fisiologicament
fisiologich	fisiologic
fisiologici	fisiologic
fisiologico	fisiologic
fisiologo	fisiologo
fisionomia	fisionomia
fisioterapia	fisioterapia
fisioterapich	fisioterapich
fisioterapista	fisioterapist
fisioterapisti	fisioterapist
fisioterpia	fisioterpia
fisk	fisk
fisologich	fisologich
fisolosfo	fisolosfo
fisolosica	fisolosica
fisonomia	fisonomia
fiss	fiss
fissa	fissa
fissaggio	fissaggio
fissando	fissando
fissandon	fissando
fissandosi	fissandosi
fissano	fissano
fissar	fissar
fissarlo	fissarlo
fissarn	fissar
fissarono	fissarono
fissarsi	fissarsi
fissat	fissat
fissata	fissat
fissatasi	fissatasi
fissati	fissat
fissativi	fissativi
fissato	fissat
fissatosi	fissatosi
fissava	fissava
fissavano	fissavano
fissazion	fissazion
fisseranno	fisseranno
fisserebb	fisserebb
fisserebbero	fisserebbero
fisseremo	fisseremo
fisserà	fisserà
fissi	fissi
fissil	fissil
fissili	fissil
fissino	fissino
fission	fission
fisso	fisso
fissor	fisso
fissur	fissur
fissurato	fissurato
fissò	fissò
fist	fist
fister	fister
fisvi	fisvi
fit	fit
fitch	fitch
fiter	fiter
fiterman	fiterman
fitgerald	fitgerald
fitna	fitna
fito	fito
fitochimica	fitochimica
fitoplancton	fitoplancton
fitosanitari	fitosanitari
fitosanitario	fitosanitari
fitoterapia	fitoterapia
fitr	fitr
fitt	fitt
fitta	fitta
fitti	fitti
fittil	fitti
fittipaldi	fittipaldi
fittissima	fittissim
fittissimi	fittissim
fittissimo	fittissim
fittizi	fittizi
fittizia	fittizi
fittiziament	fittiziament
fittizio	fittizi
fitto	fitto
fitz	fitz
fitzalan	fitzalan
fitzerald	fitzerald
fitzgerald	fitzgerald
fitzroi	fitzroi
fitzsimon	fitzsimon
fitzwat	fitzwat
fiudcia	fiudcia
fiuducia	fiuducia
fiuggi	fiuggi
fium	fium
fiuman	fiuman
fiumana	fiuman
fiumesanto	fiumesanto
fiumi	fiumi
fiumiciattolo	fiumiciattolo
fiumicino	fiumicino
fiumorbo	fiumorbo
fiuni	fiuni
fiuta	fiuta
fiutando	fiutando
fiutano	fiutano
fiutar	fiuta
fiutati	fiutat
fiutato	fiutat
fiuto	fiuto
fiutò	fiutò
fiuum	fiuum
fiv	fiv
five	five
fivizzano	fivizzano
fix	fix
fixerhotel	fixerhotel
fixerraum	fixerraum
fixerrräum	fixerrräum
fixerräum	fixerräum
fixerstub	fixerstub
fixerstübl	fixerstübl
fixot	fixot
fizhuli	fizhuli
fizuli	fizuli
fjord	fjord
fk	fk
fkf	fkf
fkgp	fkgp
fl	fl
fla	fla
flaa	flaa
flachi	flachi
flachsladen	flachsladen
flachslanden	flachslanden
flacon	flacon
flaconcino	flaconcino
flaconi	flacon
flagella	flagella
flagellando	flagellando
flagellano	flagellano
flagellar	flagella
flagellata	flagellat
flagellato	flagellat
flagellavano	flagellavano
flagellazion	flagellazion
flagelli	flagell
flagello	flagell
flageollet	flageollet
flaggellando	flaggellando
flagranmt	flagranmt
flagrant	flagrant
flagranti	flagrant
flagranza	flagranza
flak	flak
flambé	flambé
flamco	flamco
flamengo	flamengo
flament	flament
flamingo	flamingo
flaminia	flamini
flaminio	flamini
flanagan	flanagan
flander	flander
flanella	flanella
flanigan	flanigan
flannigan	flannigan
flap	flap
flash	flash
flashback	flashback
flat	flat
flatulenz	flatulenz
flauti	flaut
flautista	flautista
flauto	flaut
flavia	flavi
flavier	flavier
flavio	flavi
flavo	flavo
flavr	flavr
flawil	flawil
flawinn	flawinn
fld	fld
flebil	flebil
flebili	flebil
flebilità	flebilità
flebilment	flebilment
flebit	flebit
flebo	flebo
fleboclisi	fleboclisi
flec	flec
flecc	flecc
flecha	flecha
fledermau	fledermau
fleet	fleet
flego	flego
flegrea	flegrea
fleiner	fleiner
fleischarmen	fleischarmen
fleischer	fleischer
fleiss	fleiss
flem	flem
fleme	fleme
flemma	flemma
flemmatici	flemmatic
flemmatico	flemmatic
fleni	fleni
flensburg	flensburg
flesh	flesh
flessibil	flessibil
flessibili	flessibil
flessibilita	flessibilit
flessibilità	flessibilit
flessibilizazzion	flessibilizazzion
flessibilizzar	flessibilizzar
flessibilizzato	flessibilizzato
flessibilizzazion	flessibilizzazion
flession	flession
flessioni	flession
flesssibil	flesssibil
flessuos	flessuos
fletcher	fletcher
fletschhorn	fletschhorn
flett	flett
fleur	fleur
fleurang	fleuran
fleurant	fleuran
fleuri	fleur
fleurop	fleurop
flick	flick
flicornista	flicornista
fliegend	fliegend
flight	flight
flightlink	flightlink
flik	flik
flim	flim
flinder	flinder
flint	flint
flintston	flintston
flipper	flipper
flippin	flippin
flirt	flirt
flirta	flirta
flirtano	flirtano
flirtar	flirta
flirtarono	flirtarono
flirtato	flirtato
flirtavano	flirtavano
flirtò	flirt
flmo	flmo
flmu	flmu
fln	fln
flna	flna
flnc	flnc
flo	flo
float	float
flobert	flobert
flockhart	flockhart
floessberg	floessberg
floklor	floklor
flon	flon
flood	flood
floor	floor
flop	flop
floppi	floppi
flor	flor
flora	flora
florang	florang
flore	flore
floreal	floreal
floreali	floreal
florenc	florenc
florencia	florencia
florentino	florentino
floresta	floresta
florestano	florestano
floria	flori
floriann	floriann
florianopoli	florianopoli
florid	florid
florida	florid
floridi	florid
floridità	floridità
florido	florid
florin	flori
florinda	florinda
florio	flori
florist	florist
floristella	floristella
florstadt	florstadt
floru	floru
flossi	flossi
flott	flott
flotta	flott
flottant	flottant
flottigli	flottigli
flottiglia	flottigli
flounder	flounder
flouzat	flouzat
flow	flow
flower	flower
floxin	floxin
floyd	floyd
flp	flp
flualp	flualp
flucht	flucht
fludi	fludi
fluela	fluel
flueli	fluel
fluent	fluent
fluentement	fluentement
flughafen	flughafen
fluid	fluid
fluida	fluid
fluidi	fluidi
fluidità	fluidità
fluidià	fluidi
fluido	fluid
fluir	fluir
fluisc	fluisc
flum	flum
flument	flument
fluminens	fluminens
fluntern	fluntern
fluorescent	fluorescent
fluorescenza	fluorescenza
fluorici	fluorici
fluoro	fluoro
fluoruro	fluoruro
fluri	fluri
flurin	flurin
flurina	flurin
fluritromicina	fluritromicina
flush	flush
flussi	fluss
flusso	fluss
flutsch	flutsch
fluttazion	fluttazion
flutti	flutti
fluttua	fluttua
fluttuant	fluttuant
fluttuar	fluttua
fluttuato	fluttuato
fluttuazion	fluttuazion
fluttuazioni	fluttuazion
flutturazioni	flutturazioni
fluvial	fluvial
fluviali	fluvial
fluvoxamin	fluvoxamin
fluë	fluë
fly	fly
flyer	flyer
flynn	flynn
flüchtling	flüchtling
flückiger	flückiger
flüela	flüel
flüelen	flüelen
flüeli	flüel
flüh	flüh
flüüge	flüüge
fm	fm
fmb	fmb
fmf	fmf
fmh	fmh
fmi	fmi
fmj	fmj
fml	fml
fmln	fmln
fmlo	fmlo
fmoc	fmoc
fn	fn
fnac	fnac
fnb	fnb
fncl	fncl
fni	fni
fnl	fnl
fnla	fnla
fnlc	fnlc
fnom	fnom
fnp	fnp
fnpl	fnpl
fnr	fnr
fnsi	fnsi
fnuap	fnuap
fnv	fnv
fnzionario	fnzionario
fo	fo
foa	foa
fob	fob
fobi	fobi
fobia	fobia
foca	foca
focacc	focacc
focaccia	focaccia
focal	focal
focali	focal
focalizza	focalizza
focalizzando	focalizzando
focalizzant	focalizzant
focalizzar	focalizza
focalizzata	focalizzat
focalizzati	focalizzat
focalizzato	focalizzat
focalizzazion	focalizzazion
focalizzerà	focalizzerà
focalizzi	focalizzi
foce	foce
foch	foch
fochi	fochi
foci	foci
fock	fock
focolai	focolai
focolaio	focolai
focolar	focolar
focolari	focolar
focosa	focos
focosi	focos
focoso	focos
focu	focu
foda	foda
fodai	fodai
fodamentali	fodamentali
fodda	fodda
foder	foder
foderarla	foderarla
foderata	foderata
fodnator	fodnator
fodor	fodor
fodé	fodé
foe	foe
foelster	foelster
foerderwerk	foerderwerk
foerster	foerster
foga	foga
fogad	fogad
fogarti	fogarti
fogelberg	fogelberg
foger	foger
fogerti	fogerti
fogg	fogg
foggi	foggi
foggia	foggi
foggiano	foggiano
fogleman	fogleman
fogli	fogli
foglia	foglia
fogliace	fogliace
fogliacei	fogliace
fogliam	foglia
foglietti	fogliett
foglietto	fogliett
foglio	fogli
fogn	fogn
fogna	fogna
fognant	fognant
fognari	fognari
fognaria	fognari
fognario	fognari
fognatur	fognatur
fognatura	fognatur
fogu	fogu
fogueteiro	fogueteiro
fohn	fohn
foi	foi
foiba	foiba
foie	foie
foillard	foillard
foinaven	foinaven
foix	foix
fojnica	fojnica
fokin	fokin
fokkema	fokkema
fokker	fokker
fol	fol
fola	fola
folahian	folahian
folambrai	folambrai
folat	folat
folclor	folclor
folclorica	folcloric
folclorich	folcloric
folclorico	folcloric
folclorisitch	folclorisitch
folcloristica	folcloristic
folcloristich	folcloristic
folcloristici	folcloristic
folcloristico	folcloristic
folco	folco
folei	folei
folembrai	folembrai
folena	folena
folenbrai	folenbrai
folgor	folgor
folgorant	folgorant
folgorato	folgorato
folgorazion	folgorazion
folha	folha
foli	foli
foliazion	foliazion
folico	folico
foligno	foligno
folio	folio
folk	folk
folkeston	folkeston
folket	folket
folkhoegskolan	folkhoegskolan
folklor	folklor
folkloristica	folkloristic
folkloristich	folkloristic
folkloristici	folkloristic
folkston	folkston
foll	foll
folla	folla
follett	follett
folletti	follett
folletto	follett
folli	folli
follia	folli
follicoli	follicol
follicolo	follicol
follow	follow
follpracht	follpracht
fologorant	fologorant
folon	folon
folorunsho	folorunsho
folt	folt
folta	folta
folti	folti
foltissimo	foltissimo
folto	folto
fomba	fomba
fomc	fomc
fomenta	fomenta
fomentando	fomentando
fomentano	fomentano
fomentar	fomenta
fomentata	fomentat
fomentati	fomentat
fomentato	fomentato
fomentator	fomentato
fomenterebb	fomenterebb
foncier	foncier
fond	fond
fonda	fonda
fondaco	fondaco
fondadori	fondadori
fondal	fondal
fondali	fondal
fondamemtalista	fondamemtalista
fondamenta	fondament
fondamental	fondamental
fondamentalement	fondamentalement
fondamentali	fondamental
fondamentalisi	fondamentalisi
fondamentalismi	fondamentalism
fondamentalismo	fondamentalism
fondamentalist	fondamentalist
fondamentalista	fondamentalist
fondamentalisti	fondamentalist
fondamentalistici	fondamentalistici
fondamentalment	fondamentalment
fondamentament	fondamentament
fondamenti	fondament
fondamentlaisti	fondamentlaisti
fondamento	fondament
fondando	fondando
fondandola	fondandola
fondano	fondano
fondar	fonda
fondarla	fondarla
fondarono	fondarono
fondarsi	fondarsi
fondat	fondat
fondata	fondat
fondatezza	fondatezza
fondati	fondat
fondativo	fondativo
fondato	fondat
fondator	fondator
fondatori	fondator
fondatric	fondatric
fondatrici	fondatric
fondava	fondava
fondavano	fondavano
fondazin	fondazin
fondazion	fondazion
fondazioni	fondazion
fonder	fonder
fonderanno	fonderanno
fonderei	fonderei
fonderi	fonderi
fonderia	fonderi
fonderla	fonderla
fondersi	fondersi
fonderà	fonder
fondi	fondi
fondiari	fondiari
fondiaria	fondiari
fondiario	fondiari
fondina	fondina
fondineri	fondineri
fondo	fondo
fondomonetarist	fondomonetarist
fondomonetarista	fondomonetarist
fondono	fondono
fondoschiena	fondoschiena
fondotinta	fondotinta
fondoval	fondoval
fondu	fondu
fondò	fondò
fonema	fonema
fonet	fonet
fonetico	fonetico
fong	fong
foni	foni
fonica	fonic
fonicchi	fonicchi
fonich	fonic
fonici	fonic
fonico	fonic
fonir	fonir
foniscono	foniscono
fonit	fonit
fonjallaz	fonjallaz
fonrir	fonrir
fonrito	fonrito
font	font
fonta	fonta
fontain	fontain
fontainebleau	fontainebleau
fontainebleu	fontainebleu
fontaliero	fontaliero
fontan	fontan
fontana	fontan
fontanarossa	fontanarossa
fontanella	fontanell
fontanelli	fontanell
fontarrabi	fontarrabi
fontata	fontata
fonti	fonti
fontier	fontier
fontiera	fontier
fontipalestinesi	fontipalestinesi
fonto	fonto
fontolliet	fontolliet
fonz	fonz
fonzaso	fonzaso
foo	foo
food	food
foodchain	foodchain
foodservic	foodservic
foografi	foografi
foor	foor
foormulata	foormulata
foot	foot
footbal	footbal
for	for
fora	fora
foragger	foragger
foraggera	foragger
foragggiata	foragggiata
foraggi	foraggi
foraggia	foraggia
foraggiar	foraggia
foraggiarla	foraggiarla
foraggiato	foraggiato
foraggio	foraggi
foram	foram
forami	foram
forando	forando
forano	forano
forastieri	forastieri
forata	forat
forati	forat
forato	forato
foratom	forato
foratur	foratur
foratura	foratur
forb	forb
forbic	forbic
forbici	forbic
forbicioni	forbicioni
forbo	forbo
forbu	forbu
forc	forc
forca	forca
forcaiola	forcaiola
forcalqui	forcalqui
forcella	forcella
forcellino	forcellino
forch	forch
forchetta	forchetta
forchetton	forchetton
forchstrass	forchstrass
forcina	forcina
forcip	forcip
forcla	forcla
forclaz	forcla
forcola	forcola
ford	ford
fordham	fordham
forecast	forecast
foredeck	foredeck
foreign	foreign
forel	forel
forellini	forellini
foreman	foreman
foren	foren
forens	forens
forensi	forens
forest	forest
foresta	forest
forestal	forestal
forestali	forestal
forestazion	forestazion
foresteria	foresteria
foresti	forest
forestiero	forestiero
foreyt	foreyt
forfait	forfait
forfetario	forfetario
forfetizzazion	forfetizzazion
forfett	forfett
forfettari	forfettari
forfettaria	forfettari
forfettariament	forfettariament
forfettario	forfettari
forfettizzazion	forfettizzazion
forfora	forfor
forfori	forfor
forg	forg
forgan	forgan
forget	forget
forgia	forgia
forgiando	forgiando
forgiar	forgia
forgiata	forgiat
forgiati	forgiat
forgiatisi	forgiatisi
forgiato	forgiat
forgiatura	forgiatura
fori	fori
foria	foria
forier	forier
foriera	forier
forieri	forier
foriero	forier
forlani	forlani
forlanini	forlanini
forleo	forleo
forlives	forlives
forlì	forlì
form	form
forma	forma
formagel	formagel
formaggi	formaggi
formaggiai	formaggiai
formaggino	formaggino
formaggio	formaggi
formal	formal
formaldeid	formaldeid
formalement	formalement
formalemnt	formalemnt
formali	formal
formalina	formalina
formalismi	formalism
formalismo	formalism
formalista	formalista
formalita	formalit
formalità	formalit
formalizz	formalizz
formalizza	formalizz
formalizzando	formalizzando
formalizzano	formalizzano
formalizzar	formalizzar
formalizzarn	formalizzar
formalizzata	formalizzat
formalizzati	formalizzat
formalizzato	formalizzat
formalizzava	formalizzava
formalizzazion	formalizzazion
formalizzeranno	formalizzeranno
formalizzerà	formalizzerà
formalment	formalment
formalmet	formalmet
formalnent	formalnent
forman	forman
formando	formando
formandosi	formandosi
formano	forman
formar	formar
formarli	formarl
formarlo	formarl
formarn	formar
formarono	formarono
formarsi	formarsi
formass	formass
formassero	formassero
format	format
formata	format
formatasi	formatasi
formatesi	formatesi
formati	format
formatisi	formatisi
formativa	formativ
formativi	formativ
formativo	formativ
formato	format
formatosi	formatosi
formatzo	formatzo
formava	formava
formavano	formavano
formazion	formazion
formazioni	formazion
formel	formel
formelles	formelles
formello	formello
formenti	formenti
formentini	formentini
formeranno	formeranno
formerebb	formerebb
formeremo	formeremo
formerio	formerio
formerà	formerà
formi	formi
formia	formi
formiamo	formiamo
formica	formic
formicaio	formicaio
formich	formic
formichier	formichier
formico	formic
formicol	formicol
formicola	formicol
formicolanti	formicolanti
formicolio	formicolio
formidabil	formidabil
formidabili	formidabil
formigoni	formigoni
formin	formin
formino	formin
formir	formi
formiva	formiva
formos	formos
formosa	formos
formuat	formuat
formul	formul
formula	formula
formulando	formulando
formulano	formulano
formular	formula
formulari	formulari
formulario	formulari
formularl	formularl
formularla	formularl
formulata	formulat
formulategli	formulategli
formulati	formulat
formulato	formulat
formulatrio	formulatrio
formulava	formulava
formulazion	formulazion
formulazioni	formulazion
formuleranno	formuleranno
formulerà	formulerà
formuli	formul
formulo	formul
formult	formul
formulò	formul
formutala	formutala
formà	formà
formò	formò
fornac	fornac
fornaci	fornac
fornaciari	fornaciari
fornai	fornai
fornaio	fornai
fornara	fornar
fornaretto	fornaretto
fornari	fornar
fornasari	fornasari
fornebu	fornebu
fornei	fornei
fornelli	fornell
fornello	fornell
fornendo	fornendo
fornendoci	fornendoci
fornendogli	fornendogli
fornendon	fornendo
fornenfo	fornenfo
forni	forni
forniamo	forniamo
fornicato	fornicato
fornicazion	fornicazion
fornigli	fornigli
fornii	forni
fornimenti	fornimenti
forninr	forninr
fornir	fornir
fornira	fornir
forniranno	forniranno
fornirci	fornirci
fornirebb	fornirebb
fornirebbero	fornirebbero
forniremo	forniremo
fornirgli	fornirgli
fornirl	fornirl
fornirla	fornirl
fornirli	fornirl
fornirlo	fornirl
fornirn	fornir
fornirono	fornirono
fornirà	fornir
fornirò	fornir
fornisc	fornisc
fornisca	fornisc
forniscano	forniscano
forniscono	forniscono
forniss	forniss
fornit	fornit
fornita	fornit
fornitel	fornitel
forniteloro	forniteloro
forniti	fornit
fornitigli	fornitigli
fornito	fornit
fornitogli	fornitogli
fornitor	fornitor
fornitori	fornitor
fornitric	fornitric
fornitrici	fornitric
fornitur	fornitur
fornitura	fornitur
fornità	fornit
forniva	forniva
fornivano	fornivano
forno	forno
fornt	fornt
forntiera	forntiera
fornì	fornì
foro	foro
forod	forod
fororeport	fororeport
forpronu	forpronu
forra	forra
forrer	forrer
forrest	forrest
forru	forru
fors	fors
forsa	forsa
forschner	forschner
forschung	forschung
forschungsgrupp	forschungsgrupp
forsennata	forsennat
forsennati	forsennat
forsennato	forsennat
forssbackk	forssbackk
forst	forst
forster	forster
forsthau	forsthau
forstmann	forstmann
forsyth	forsyth
forsz	forsz
fort	fort
fortaleza	fortaleza
fortean	fortean
fortedel	fortedel
forteleza	forteleza
fortemement	fortemement
fortement	fortement
fortementi	fortement
fortensyk	fortensyk
fortestal	fortestal
fortezz	fortezz
fortezza	fortezz
forth	forth
forti	forti
forticar	forticar
fortifiacazion	fortifiacazion
fortifica	fortifica
fortificant	fortificant
fortificar	fortifica
fortificata	fortificat
fortificato	fortificat
fortificazaioni	fortificazaioni
fortificazion	fortificazion
fortificazioni	fortificazion
fortilizio	fortilizio
fortin	fortin
fortini	fortin
fortino	fortin
fortissim	fortissim
fortissima	fortissim
fortissimament	fortissimament
fortissimi	fortissim
fortissimo	fortissim
fortitud	fortitud
forto	forto
forton	forto
fortschen	fortschen
fortuit	fortuit
fortuita	fortuit
fortuiti	fortuit
fortuito	fortuit
fortun	fortun
fortuna	fortun
fortunament	fortunament
fortunata	fortunat
fortunatament	fortunatament
fortunati	fortunat
fortunatissim	fortunatissim
fortunato	fortunat
fortunella	fortunella
fortunosament	fortunosament
fortunoso	fortunoso
forum	forum
forumw	forum
foruncoli	foruncoli
foruncolon	foruncolon
foruzech	foruzech
forward	forward
forz	forz
forza	forza
forzaitalia	forzaitalia
forzando	forzando
forzandoli	forzandoli
forzano	forzano
forzar	forza
forzargli	forzargli
forzarl	forzarl
forzarlo	forzarl
forzarmi	forzarmi
forzarono	forzarono
forzat	forzat
forzata	forzat
forzatament	forzatament
forzati	forzat
forzato	forzat
forzatur	forzatur
forzatura	forzatur
forzeranno	forzeranno
forzeremo	forzeremo
forzerà	forzerà
forzier	forzier
forzieri	forzier
forzista	forzist
forzisti	forzist
forzosa	forzos
forzosament	forzosament
forzosi	forzos
forzoso	forzos
forzò	forzò
forêt	forêt
fosca	fosca
foscal	fosca
foscari	foscari
fosch	fosch
foschi	foschi
foschia	foschi
foschini	foschini
fosco	fosco
fose	fose
fosfati	fosfat
fosfato	fosfat
fosforescent	fosforescent
fosforescenti	fosforescent
fosforico	fosforico
fosforo	fosforo
fosgen	fosgen
fosler	fosler
foss	foss
fossa	fossa
fossati	fossat
fossato	fossat
fossei	fosse
fosseo	fosse
fosser	fosse
fosserono	fosserono
fossetta	fossetta
fossil	fossil
fossili	fossil
fossilizz	fossilizz
fossilizzandosi	fossilizzandosi
fossilizzati	fossilizzat
fossilizzato	fossilizzat
fosso	fosso
fossombron	fossombron
fossò	fossò
fost	fost
foster	foster
fot	fot
foter	foter
foti	foti
foto	foto
fotoamator	fotoamator
fotocellul	fotocellul
fotochimich	fotochimich
fotocopi	fotocopi
fotocopia	fotocopia
fotocopiar	fotocopia
fotocopiata	fotocopiat
fotocopiati	fotocopiat
fotocopiato	fotocopiat
fotocopiatric	fotocopiatric
fotocopiatrici	fotocopiatric
fotocopiava	fotocopiava
fotoelettrich	fotoelettrich
fotofinish	fotofinish
fotogenia	fotogenia
fotogenica	fotogenic
fotogenich	fotogenic
fotogiornalismo	fotogiornalismo
fotograf	fotograf
fotografa	fotografa
fotografando	fotografando
fotografandoli	fotografandol
fotografandolo	fotografandol
fotografano	fotografano
fotografar	fotografa
fotografarli	fotografarli
fotografata	fotografat
fotografati	fotografat
fotografato	fotografat
fotografava	fotografava
fotograferanno	fotograferanno
fotografi	fotografi
fotografia	fotografi
fotografica	fotografic
fotografich	fotografic
fotografici	fotografic
fotografico	fotografic
fotografo	fotograf
fotografò	fotograf
fotogramma	fotogramm
fotogrammetria	fotogrammetria
fotogrammi	fotogramm
fotograr	fotograr
fotokol	fotokol
fotomodel	fotomodel
fotomodella	fotomodell
fotomodelli	fotomodell
fotomontaggi	fotomontaggi
fotomuseum	fotomuseum
fotoreport	fotoreport
fotoromanzi	fotoromanz
fotoromanzo	fotoromanz
fotosensibilizzanti	fotosensibilizzanti
fotosintesi	fotosintesi
fotostatica	fotostatica
fototecnici	fototecnici
fototografi	fototografi
fotovoltaica	fotovoltaic
fotovoltaich	fotovoltaic
fotovoltaici	fotovoltaic
fotovoltaico	fotovoltaic
fotti	fotti
fottuta	fottut
fottutissimi	fottutissimi
fottuto	fottut
fotunatament	fotunatament
fotò	fotò
fou	fou
fouad	fouad
foucaud	foucaud
foucault	foucault
fouché	fouché
fougner	fougner
foulard	foulard
foulk	foulk
found	found
foundat	foundat
founex	founex
fountain	fountain
fouquet	fouquet
fourcad	fourcad
fouri	fouri
fourier	fourier
fournial	fournial
fournier	fournier
fourtou	fourtou
foust	foust
foutu	foutu
fovern	fovern
fowl	fowl
fowler	fowler
fox	fox
foxboro	foxboro
foxhal	foxhal
foxlei	foxlei
foxman	foxman
foxtrot	foxtrot
foxwood	foxwood
foyer	foyer
foz	foz
foza	foza
foze	foze
fozz	fozz
fp	fp
fp25	fp25
fpa	fpa
fpc	fpc
fpd	fpd
fpi	fpi
fpl	fpl
fplp	fplp
fpn	fpn
fpoe	fpoe
fpp	fpp
fpr	fpr
fpö	fpö
fr	fr
fr1	fr1
fr2	fr2
fr3	fr3
fra	fra
fraancesi	fraancesi
frabetti	frabetti
frac	frac
fracanzani	fracanzani
fracass	fracass
fracassa	fracassa
fracassando	fracassando
fracassandola	fracassandola
fracassar	fracassa
fracassata	fracassat
fracassato	fracassat
fracasso	fracass
fracassò	fracass
fracci	fracci
fracensco	fracensco
fraces	fraces
frachi	frachi
fracnes	fracnes
fracnesi	fracnes
fracnhi	fracnhi
fradicio	fradicio
fraffico	fraffico
fraga	fraga
fragalà	fragalà
fragil	fragil
fragili	fragil
fragilissima	fragilissima
fragilità	fragilità
fragli	fragli
fragliasso	fragliasso
fragol	fragol
fragola	fragol
fragor	fragor
fragori	fragor
fragoros	fragoros
fragorosa	fragoros
fragorosament	fragorosament
fragoroso	fragoros
fragrant	fragrant
fragranti	fragrant
fragranz	fragranz
fragranza	fragranz
frai	frai
fraih	fraih
fraintendetemi	fraintendetemi
fraintendimenti	fraintendimenti
fraintes	fraintes
fraintesa	fraintes
fraintesi	fraintes
frainteso	fraintes
fraizzoli	fraizzoli
fraka	fraka
fraktion	fraktion
fralei	fralei
framassoni	framassoni
framatom	framatom
frambourg	frambourg
framchi	framchi
framework	framework
framk	framk
frammenta	frammenta
frammentandolo	frammentandolo
frammentar	frammenta
frammentari	frammentari
frammentaria	frammentari
frammentario	frammentari
frammentarlo	frammentarlo
frammentata	frammentat
frammentati	frammentat
frammentatisi	frammentatisi
frammentato	frammentat
frammentatosi	frammentatosi
frammentazion	frammentazion
frammentazioni	frammentazion
frammenti	framment
frammento	framment
frammezzati	frammezzati
frampton	frampton
fran	fran
frana	frana
franar	frana
franat	franat
franata	franat
franato	franat
franc	franc
franca	franc
francai	francai
francais	francai
francamant	francamant
francament	francament
francavilla	francavilla
france2	france2
franceco	franceco
frances	frances
francesaco	francesaco
francesca	francesc
francescan	francescan
francescana	francescan
francescani	francescan
francescano	francescan
franceschelli	franceschelli
franceschi	franceschi
franceschini	franceschini
francesco	francesc
francesconi	francesconi
francesi	frances
francesismi	francesismi
francesissimo	francesissimo
franceso	frances
francesé	frances
francfort	francfort
franch	franc
franchbi	franchbi
franchetti	franchetti
franchezza	franchezza
franchi	franchi
franchigi	franchigi
franchigia	franchigi
franchini	franchini
franchis	franchi
franchismo	franchismo
franchista	franchist
franchisti	franchist
franchiö	franchi
franci	franci
francia	franci
francin	franci
francion	francion
franciosi	franciosi
francisco	francisc
franciscu	francisc
francisqu	francisqu
franciuk	franciuk
francià	franci
franck	franc
franco	franc
francobolli	francoboll
francobollo	francoboll
francofilo	francofilo
francofon	francofon
francofona	francofon
francofoni	francofoni
francofonia	francofoni
francofono	francofon
francofort	francofort
francofortesi	francofortesi
francoi	francoi
francois	francoi
franconia	franconia
francopia	francopia
francotedesca	francotedesca
francovich	francovich
francé	franc
frandkoff	frandkoff
frane	frane
frang	frang
frangent	frangent
frangenti	frangent
franghi	franghi
frangia	frangia
frangjiyeh	frangjiyeh
franglai	franglai
franguin	franguin
franham	franham
franhci	franhci
franjio	franjio
franjo	franjo
frank	frank
frankel	franke
franken	franke
frankenberg	frankenberg
frankenhaim	frankenhaim
frankenhal	frankenhal
frankenheim	frankenheim
frankenstein	frankenstein
frankestein	frankestein
frankfurt	frankfurt
frankhaus	frankhaus
franklin	franklin
frankovsk	frankovsk
frankson	frankson
frankstein	frankstein
franmces	franmces
franosi	franos
franoso	franos
franquet	franquet
franson	franson
frantisek	frantisek
frantum	frantum
frantuma	frantuma
frantumano	frantumano
frantumar	frantuma
frantumarsi	frantumarsi
frantumata	frantumat
frantumatasi	frantumatasi
frantumati	frantumat
frantumato	frantumat
frantumazion	frantumazion
frantumi	frantum
frantumò	frantum
frantuni	frantuni
frantz	frantz
franz	franz
franzelin	franzelin
franzisca	franzisc
franziscu	franzisc
franziska	franziska
franzoni	franzoni
françai	françai
français	françai
françoi	françoi
françois	françoi
fraontalieri	fraontalieri
frap	frap
frapah	frapah
fraph	fraph
frapp	frapp
frappat	frappat
frappon	frappon
frapponendo	frapponendo
frapponess	frapponess
frapponessero	frapponessero
frapponeva	frapponeva
frappongono	frappongono
frapporr	frapporr
frapporrano	frapporrano
frapporsi	frapporsi
frappost	frappost
frapposti	frappost
frapposto	frappost
frappé	frapp
frapö	frapö
fraquelli	fraquelli
fraquentano	fraquentano
fraquentava	fraquentava
frascati	frascati
frasch	frasch
frasdorf	frasdorf
frase	frase
fraseggi	fraseggi
fraseggio	fraseggi
fraseologia	fraseologia
fraser	frase
frasett	frasett
frasi	frasi
fraskfort	fraskfort
frasn	frasn
frassati	frassati
frasser	frasser
frassinelli	frassinelli
frastagliata	frastagliat
frastagliati	frastagliat
frastagliato	frastagliat
frastornata	frastornat
frastornati	frastornat
frastornato	frastornat
frastuono	frastuono
fratacci	fratacci
frate	frate
fratel	frate
fratellanza	fratellanza
fratellastri	fratellastr
fratellastro	fratellastr
fratellenza	fratellenza
fratelli	fratell
fratellini	fratellin
fratellino	fratellin
fratello	fratell
fratellò	fratell
fratern	fratern
fraterna	fratern
fraternament	fraternament
fraterni	fratern
fraternita	fraternit
fraternità	fraternit
fraternité	fraternit
fraternizzar	fraternizzar
fraternizzato	fraternizzato
fraterno	fratern
frati	frati
fratia	frati
fraticidi	fraticidi
fratini	fratini
fratricid	fratricid
fratricida	fratricid
fratricidi	fratricidi
fratricidio	fratricidi
frattagli	frattagli
frattampo	frattampo
frattanto	frattanto
frattempo	frattempo
frattur	frattur
frattura	frattur
fratturandosi	fratturandosi
fratturata	fratturat
fratturato	fratturat
fratturò	frattur
frau	frau
fraubrunnen	fraubrunnen
frauchig	frauchig
fraudolent	fraudolent
fraudolenta	fraudolent
fraudolenti	fraudolent
fraudolento	fraudolent
frauen	frauen
frauenfeld	frauenfeld
frauengluck	frauengluck
frauenhau	frauenhau
frauenkappelen	frauenkappelen
frauenkirch	frauenkirch
frauennot	frauennot
frauk	frauk
fraunefeld	fraunefeld
frazier	frazier
frazion	frazion
frazionamento	frazionamento
frazionar	frazionar
frazionata	frazionat
frazionati	frazionat
frazionato	frazionat
frazioni	frazion
frazionista	frazionista
frc	frc
fre	fre
freancofono	freancofono
freatica	freatic
freatich	freatic
frecc	frecc
freccett	freccett
freccia	freccia
frecciat	frecciat
frecciata	frecciat
frecciatina	frecciatina
frech	frech
fred	fred
fredagsvik	fredagsvik
fredd	fredd
fredda	fredda
freddament	freddament
freddando	freddando
freddandoli	freddandoli
freddar	fredda
freddarono	freddarono
freddat	freddat
freddata	freddat
freddati	freddat
freddato	freddat
freddezza	freddezza
freddi	fredd
freddino	freddino
freddissim	freddissim
freddissima	freddissim
freddissimi	freddissim
freddissimo	freddissim
freddo	fredd
freddolosi	freddolosi
freddur	freddur
freder	freder
frederck	frederck
frederich	frederic
frederick	frederic
frederico	frederic
frederik	frederik
frederikshavn	frederikshavn
frederiksvaerk	frederiksvaerk
frederk	freder
fredi	fredi
fredrick	fredrick
fredrik	fredrik
fredriksson	fredriksson
free	free
freed	freed
freedman	freedman
freedom	freedo
freedon	freedo
freeedom	freeedom
freeh	freeh
freehil	freehil
freehold	freehold
freelanc	freelanc
freeli	freeli
freeman	freeman
freement	freement
freetown	freetown
freewai	freewai
frega	frega
fregar	frega
fregat	fregat
fregata	fregat
fregatura	fregatura
fregen	fregen
freghi	freghi
fregi	fregi
fregia	fregia
fregiar	fregia
fregiarsen	fregiarsen
fregiarsi	fregiarsi
fregiavano	fregiavano
fregio	fregi
fregioornamental	fregioornamental
fregnacc	fregnacc
frego	frego
fregoners	fregoners
fregosi	fregosi
freguglia	freguglia
freh	freh
frehner	frehner
frei	frei
freibug	freibug
freiburg	freiburg
freiburghau	freiburghau
freidrichshafen	freidrichshafen
freie	freie
freienbach	freienbach
freienwald	freienwald
freier	freie
freight	freight
freih	freih
freiha	freih
freiherr	freiherr
freij	freij
freimaurerei	freimaurerei
freimüller	freimüller
freir	freir
freis	freis
freischütz	freischütz
freistaat	freistaat
freivogel	freivogel
freizeitpark	freizeitpark
freju	freju
frekendorf	frekendorf
frelimo	frelimo
frelon	frelon
fremantl	fremantl
frement	frement
fremer	fremer
fremiti	fremit
fremito	fremit
fremont	fremont
frena	frena
frenaggio	frenaggio
frenando	frenando
frenano	frenano
frenant	frenant
frenanti	frenant
frenar	frenar
frenarl	frenarl
frenarla	frenarl
frenarli	frenarl
frenarn	frenar
frenarsi	frenarsi
frenat	frenat
frenata	frenat
frenati	frenat
frenato	frenat
frenatura	frenatura
frenava	frenava
french	frenc
frenck	frenc
frend	frend
frene	frene
freneranno	freneranno
frenerebbero	frenerebbero
frenerà	frenerà
frenesia	frenesia
frenetica	frenetic
freneticament	freneticament
frenetich	frenetic
frenetici	frenetic
frenetico	frenetic
freni	freni
frenino	frenino
frenk	frenk
frenkel	frenkel
frenkelstein	frenkelstein
frenkendorf	frenkendorf
freno	freno
frenquellucci	frenquellucci
frenquent	frenquent
frenquentano	frenquentano
frent	frent
frentzel	frentzel
frequantati	frequantati
frequent	frequent
frequenta	frequenta
frequentabili	frequentabili
frequentai	frequenta
frequentando	frequentando
frequentandosi	frequentandosi
frequentano	frequentano
frequentar	frequenta
frequentarsi	frequentarsi
frequentata	frequentat
frequentatata	frequentatata
frequentati	frequentat
frequentatissima	frequentatissim
frequentatissimi	frequentatissim
frequentato	frequentat
frequentator	frequentator
frequentatori	frequentator
frequentatric	frequentatric
frequentava	frequentav
frequentavamo	frequentavamo
frequentavano	frequentavano
frequentavo	frequentav
frequentazion	frequentazion
frequentazioni	frequentazion
frequentement	frequentement
frequenteranno	frequenteranno
frequenterebb	frequenterebb
frequenti	frequent
frequentissim	frequentissim
frequentissima	frequentissim
frequentissimi	frequentissim
frequentò	frequent
frequenz	frequenz
frequenza	frequenz
frequestatric	frequestatric
frequesti	frequesti
frere	frere
fresa	fresa
fresatrici	fresatrici
fresca	fresc
fresch	fresch
freschezza	freschezza
freschi	fresch
freschissimi	freschissimi
fresco	fresc
frescura	frescura
frese	frese
freshman	freshman
fresi	fresi
fresilli	fresilli
fresn	fresn
fresno	fresn
frethun	frethun
fretta	fretta
frettolos	frettolos
frettolosa	frettolos
frettolosament	frettolosament
frettolosi	frettolos
frettolosità	frettolosità
frettoloso	frettolos
freud	freud
freudent	freudent
freudian	freudian
freudiana	freudian
freudiano	freudian
freundin	freundin
frewald	frewald
frewi	frewi
frewin	frewi
freydl	freydl
freymond	freymond
frezzetti	frezzetti
frg	frg
fri	fri
fria	fria
friabil	friabil
friborgo	friborgo
fribourg	fribourg
fribughes	fribughes
friburg	friburg
friburghes	friburghes
friburghesi	friburghes
friburgo	friburg
friburo	friburo
frichknecht	frichknecht
frick	frick
fricker	fricker
fricktal	fricktal
frida	frida
fridai	frida
fridan	frida
friderici	friderici
fridkin	fridkin
fridolin	fridolin
fridrich	fridrich
fridtjof	fridtjof
frie	frie
friecrichshafen	friecrichshafen
frieda	frieda
friedackerstrass	friedackerstrass
friedel	friede
frieder	friede
friederich	friederic
friederici	friederic
friedhelm	friedhelm
friedirich	friedirich
friedland	friedland
friedli	friedli
friedman	friedman
friedmann	friedman
friedrich	friedrich
friedrichsfeld	friedrichsfeld
friedrichshafen	friedrichshafen
friedrichshain	friedrichshain
friedrichstrass	friedrichstrass
friend	friend
friesenberg	friesenberg
frieson	frieson
friet	friet
frigerio	frigerio
friggebo	friggebo
frigger	frigger
friggerla	friggerla
friggitric	friggitric
frigidità	frigidità
frigo	frigo
frigofera	frigofera
frigorifer	frigorifer
frigorifera	frigorifer
frigoriferi	frigorifer
frigorifero	frigorifer
friji	friji
frikret	frikret
fring	fring
fringillid	fringillid
fringillidi	fringillid
frinir	frinir
friniscono	friniscono
frink	frink
friolo	friolo
frisani	frisani
frisbe	frisbe
frisch	frisc
frischknecht	frischknecht
friscknecht	friscknecht
frisco	frisc
frisi	frisi
frisia	frisi
frisk	frisk
friso	friso
frison	friso
frist	frist
frit	frit
fritigland	fritigland
fritsch	fritsch
fritschi	fritsch
fritt	fritt
fritta	fritt
frittat	frittat
frittata	frittat
frittel	fritte
fritteö	fritte
fritti	fritt
fritto	fritt
frittur	frittur
frittura	frittur
fritz	fritz
friul	friul
friulana	friulan
friulani	friulan
friulano	friulan
friuli	friul
frivola	frivol
frivolezz	frivolezz
frivoli	frivol
frivolo	frivol
frizion	frizion
frizioni	frizion
frizzant	frizzant
frizzanti	frizzant
frizzantissima	frizzantissima
frizzi	frizzi
frnachi	frnachi
frnahci	frnahci
frnce	frnce
frnchi	frnchi
frnk	frnk
frnçoi	frnçoi
fro	fro
frochaux	frochaux
froci	froci
froda	froda
frodar	froda
frodat	frodat
frodata	frodat
frodato	frodat
frodatori	frodatori
frode	frode
frodebu	frodebu
frodi	frodi
frodo	frodo
froehlich	froehlich
froelich	froelich
froggart	froggart
froggatt	froggatt
frogoriferi	frogoriferi
froid	froid
froin	froin
froio	froio
fromag	fromag
fromaggi	fromaggi
froment	froment
fromet	fromet
frometa	fromet
frommel	frommel
fromstein	fromstein
fromular	fromular
fronda	fronda
frondisti	frondisti
froniera	froniera
fronitera	fronitera
front	front
fronta	front
frontal	frontal
frontalement	frontalement
frontali	frontal
frontalier	frontalier
frontaliera	frontalier
frontalierato	frontalierato
frontalieri	frontalier
frontaliero	frontalier
frontalment	frontalment
fronteggerà	fronteggerà
fronteggi	fronteggi
fronteggia	fronteggia
fronteggiando	fronteggiando
fronteggiano	fronteggiano
fronteggiar	fronteggia
fronteggiarsi	fronteggiarsi
fronteggiata	fronteggiat
fronteggiati	fronteggiat
fronteggiato	fronteggiat
fronteggiavano	fronteggiavano
frontespizio	frontespizio
fronti	fronti
fronti0	fronti
frontier	frontier
frontiera	frontier
frontierea	frontierea
frontierà	frontier
frontini	frontini
frontir	fronti
frontisti	frontisti
frontièr	frontièr
fronto	front
fronton	fronton
frontoni	fronton
frontr	front
frontèr	frontèr
fronté	front
fronza	fronza
fronzoli	fronzoli
frosinon	frosinon
frossard	frossard
frost	frost
froster	froster
frotini	frotini
frotniera	frotniera
frott	frott
frottol	frottol
frou	frou
frouk	frouk
froza	froza
frp	frp
frudesa	frudesa
fruga	fruga
frugal	fruga
frugalità	frugalità
frugando	frugando
frugano	frugano
frugar	fruga
frugato	frugato
frugatori	frugatori
fruger	fruger
fruibili	fruibili
fruibourg	fruibourg
fruir	fruir
fruirebbero	fruirebbero
fruirà	fruir
fruisc	fruisc
fruiscono	fruiscono
fruit	fruit
fruitel	fruitel
fruito	fruit
fruitor	fruitor
fruitori	fruitor
fruizion	fruizion
frullatori	frullatori
frumento	frumento
frunz	frunz
fruscianti	fruscianti
frusciar	frusciar
fruscio	fruscio
frust	frust
frusta	frusta
frustar	frusta
frustarli	frustarl
frustarlo	frustarl
frustat	frustat
frustata	frustat
frustati	frustat
frustato	frustat
frusti	frust
frustrando	frustrando
frustrant	frustrant
frustranti	frustrant
frustrar	frustrar
frustrat	frustrat
frustrata	frustrat
frustrati	frustrat
frustrato	frustrat
frustrazion	frustrazion
frustrazioni	frustrazion
fruthwilen	fruthwilen
frutigen	frutigen
frutigland	frutigland
frutta	frutta
fruttando	fruttando
fruttano	fruttan
fruttant	fruttan
fruttar	frutta
fruttata	fruttat
fruttati	fruttat
fruttato	fruttat
fruttava	fruttava
frutteranno	frutteranno
frutterebb	frutterebb
frutterebbero	frutterebbero
fruttero	frutter
frutterà	frutter
frutteti	fruttet
frutteto	fruttet
frutti	frutt
frutticoltori	frutticoltori
fruttivendolo	fruttivendolo
frutto	frutt
fruttosio	fruttosio
fruttoso	fruttoso
fruttuos	fruttuos
fruttuosa	fruttuos
fruttuosi	fruttuos
fruttuoso	fruttuos
fruttò	frutt
fryc	fryc
frydlant	frydlant
fryer	fryer
frà	frà
frédy	frédy
frédéric	frédéric
frédérich	frédéric
fréju	fréju
fréquenc	fréquenc
frösch	frösch
früh	früh
frühbeck	frühbeck
fründen	fründen
fründenhorn	fründenhorn
fsacl	fsacl
fsag	fsag
fsc	fsc
fscc	fscc
fse	fse
fsea	fsea
fsfp	fsfp
fsg	fsg
fsi	fsi
fsk	fsk
fsln	fsln
fsm	fsm
fsmo	fsmo
fsn	fsn
fso	fso
fsp	fsp
fsr	fsr
fsrt	fsrt
fss	fss
fssc	fssc
fssi	fssi
fst	fst
fstp	fstp
ft	ft
ftacnik	ftacnik
ftase	ftase
ftb	ftb
ftc	ftc
ftca	ftca
fthiotida	fthiotida
ftse	ftse
fuad	fuad
fuarc	fuarc
fuat	fuat
fucek	fucek
fuch	fuch
fuchen	fuchen
fucheng	fuchen
fuchi	fuchi
fuchun	fuchun
fuci	fuci
fucil	fucil
fucilamento	fucilamento
fucilano	fucilano
fucilar	fucilar
fucilarono	fucilarono
fucilata	fucilat
fucilati	fucilat
fucilato	fucilat
fucilazion	fucilazion
fucilazioni	fucilazion
fucileria	fucileria
fucili	fucil
fucilier	fucilier
fucilieri	fucilier
fucin	fucin
fucina	fucina
fucinar	fucina
fuck	fuck
fucsia	fucsia
fudan	fudan
fuducia	fuducia
fueher	fueher
fuehrer	fuehrer
fuehrerstaat	fuehrerstaat
fuel	fuel
fuela	fuela
fuent	fuent
fuenturbel	fuenturbel
fuerst	fuerst
fuerstenfeldbruck	fuerstenfeldbruck
fuerteventura	fuerteventura
fuerth	fuerth
fuessen	fuessen
fuest	fuest
fuezessi	fuezessi
fuga	fuga
fugac	fugac
fugaci	fugac
fugando	fugando
fugar	fugar
fugat	fugat
fugata	fugat
fugati	fugat
fugato	fugat
fugelli	fugelli
fugg	fugg
fugga	fugga
fuggendo	fuggendo
fuggent	fuggent
fuggevoli	fuggevoli
fugggir	fugggir
fuggi	fuggi
fuggiasca	fuggiasc
fuggiaschi	fuggiaschi
fuggiasco	fuggiasc
fuggifuggi	fuggifuggi
fuggimmo	fuggimmo
fuggir	fuggir
fuggirebbero	fuggirebbero
fuggirn	fuggir
fuggirono	fuggirono
fuggirà	fuggir
fuggirò	fuggir
fuggit	fuggit
fuggita	fuggit
fuggiti	fuggit
fuggitivi	fuggitiv
fuggitivo	fuggitiv
fuggito	fuggit
fuggiva	fuggiva
fuggivano	fuggivano
fuggo	fuggo
fuggono	fuggono
fuggì	fuggì
fugh	fugh
fugherà	fugherà
fugit	fugit
fugon	fugon
fugurar	fugurar
fuhlsbuettel	fuhlsbuettel
fuhrer	fuhrer
fuhrman	fuhrman
fuhrmann	fuhrman
fuim	fuim
fuinzionario	fuinzionario
fujahirah	fujahirah
fujairah	fujairah
fuji	fuji
fujian	fujian
fujiarah	fujiarah
fujii	fujii
fujimi	fujimi
fujimori	fujimori
fujinami	fujinami
fujitsu	fujitsu
fujumori	fujumori
fuk	fuk
fukami	fukami
fukeh	fukeh
fukom	fukom
fukui	fukui
fukuoka	fukuoka
fukushima	fukushima
fukuto	fukuto
fukutoku	fukutoku
fukuzawa	fukuzawa
fulani	fulani
fulbrigh	fulbrigh
fulbright	fulbrigh
fulchignoni	fulchignoni
fulci	fulci
fulcieri	fulcieri
fulcri	fulcr
fulcro	fulcr
fulda	fulda
fuldner	fuldner
fulgencio	fulgencio
fulgida	fulgid
fulgido	fulgid
fulgor	fulgor
fulham	fulham
fuliggin	fuliggin
fulimin	fulimin
fuliminato	fuliminato
full	full
fullbright	fullbright
fuller	fuller
fullerton	fullerton
fulli	fulli
fulmim	fulmim
fulmin	fulmin
fulmina	fulmina
fulminandolo	fulminandolo
fulminant	fulminant
fulminar	fulmina
fulminata	fulminat
fulminati	fulminat
fulminato	fulminat
fulminea	fulmine
fulmineo	fulmine
fulmini	fulmin
fulton	fulton
fulu	fulu
fulva	fulva
fulvi	fulvi
fulvio	fulvi
fuma	fuma
fumag	fumag
fumando	fumando
fumano	fumano
fumant	fumant
fumanti	fumant
fumar	fumar
fumaria	fumaria
fumarico	fumarico
fumarla	fumarl
fumarli	fumarl
fumarlo	fumarl
fumaroli	fumaroli
fumarsi	fumarsi
fumassero	fumassero
fumat	fumat
fumata	fumat
fumato	fumat
fumator	fumator
fumatori	fumator
fumatric	fumatric
fumatrici	fumatric
fumava	fumava
fumavano	fumavano
fumeranno	fumeranno
fumeri	fumeri
fumeria	fumeri
fumerà	fumerà
fumetti	fumett
fumettisti	fumettisti
fumetto	fumett
fumi	fumi
fumid	fumid
fumigazion	fumigazion
fumimaro	fumimaro
fumino	fumino
fumio	fumio
fumisteri	fumisteri
fumisti	fumisti
fumo	fumo
fumogen	fumogen
fumogena	fumogen
fumogeni	fumogen
fumogeno	fumogen
fumos	fumos
fumosa	fumos
fumosi	fumos
fumoso	fumos
fumu	fumu
fumò	fumò
fun	fun
funai	funai
funamboli	funambol
funambolico	funambolico
funambolo	funambol
funambulismo	funambulismo
funari	funari
funazionari	funazionari
funcheng	funcheng
funcinpec	funcinpec
fund	fund
fundacao	fundacao
fundament	fundament
fundia	fundia
fundo	fundo
fune	fune
funeali	funeali
funebr	funebr
funebri	funebr
funer	funer
funeral	funeral
funeralcar	funeralcar
funerali	funeral
funerari	funerari
funeraria	funerari
funerario	funerari
funerea	funerea
funest	funest
funesta	funest
funestando	funestando
funestarono	funestarono
funestata	funestat
funestati	funestat
funestato	funestat
funesti	funest
funestino	funestino
funesto	funest
fung	fung
fungendo	fungendo
funger	funger
fungeranno	fungeranno
fungerebbero	fungerebbero
fungerà	funger
fungeva	fungeva
fungevano	fungevano
funghetto	funghetto
funghi	funghi
fungiatt	fungiatt
fungo	fungo
fungono	fungono
funi	funi
funicolar	funicolar
funicolari	funicolar
funivi	funivi
funivia	funivi
funk	funk
funki	funki
funlandia	funlandia
funni	funni
funto	funto
funubr	funubr
funxionario	funxionario
funza	funza
funzinamento	funzinamento
funzinar	funzinar
funzinario	funzinario
funzioanri	funzioanri
funzioanrio	funzioanri
funzion	funzion
funziona	funzion
funzionaento	funzionaento
funzional	funzional
funzionali	funzional
funzionalita	funzionalit
funzionalità	funzionalit
funzionalment	funzionalment
funzionamenti	funzionament
funzionamento	funzionament
funzionando	funzionando
funzionano	funzionano
funzionant	funzionant
funzionanti	funzionant
funzionar	funzionar
funzionari	funzionari
funzionaria	funzionari
funzionariato	funzionariato
funzionaridel	funzionaridel
funzionario	funzionari
funzionaro	funzionar
funzionarono	funzionarono
funzionass	funzionass
funzionassero	funzionassero
funzionati	funzionat
funzionato	funzionat
funzionava	funzionava
funzionei	funzionei
funzioneranno	funzioneranno
funzionerebb	funzionerebb
funzionerà	funzionerà
funzioni	funzioni
funzionia	funzioni
funzioniamo	funzioniamo
funzionino	funzionino
funzionnario	funzionnario
funzionò	funzion
funzioona	funzioona
funzioonamento	funzioonamento
funèbr	funèbr
fuoc	fuoc
fuochi	fuochi
fuochista	fuochista
fuoco	fuoco
fuocosparati	fuocosparati
fuond	fuond
fuor	fuor
fuorché	fuorché
fuori	fuori
fuoricampo	fuoricampo
fuoricasta	fuoricasta
fuoriesc	fuoriesc
fuoriesca	fuoriesc
fuoriescono	fuoriescono
fuorigrotta	fuorigrotta
fuorilegg	fuorilegg
fuoripista	fuoripista
fuoriscita	fuoriscit
fuoriscito	fuoriscit
fuoristrada	fuoristrada
fuoriusc	fuoriusc
fuoriuscent	fuoriuscent
fuoriuscir	fuoriuscir
fuoriuscit	fuoriuscit
fuoriuscita	fuoriuscit
fuoriuscito	fuoriuscit
fuoriusciva	fuoriusciva
fuorono	fuorono
fuoruscir	fuoruscir
fuoruscit	fuoruscit
fuoruscita	fuoruscit
fuoruscito	fuoruscit
fuorviant	fuorviant
fuorvianti	fuorviant
fuorviarlo	fuorviarlo
fur	fur
furano	furano
furazolidon	furazolidon
furbacchioni	furbacchioni
furbastro	furbastro
furbescament	furbescament
furbesco	furbesco
furbi	furbi
furbissimi	furbissimi
furbizi	furbizi
furbizia	furbizi
furbo	furbo
fure	fure
furent	furent
furer	furer
furfant	furfant
furfanti	furfant
furfaro	furfaro
furger	furger
furgler	furgler
furgon	furgon
furgonata	furgonata
furgoncini	furgoncin
furgoncino	furgoncin
furgoni	furgon
furi	furi
furia	furia
furiani	furiani
furibond	furibond
furibonda	furibond
furibondi	furibond
furibondo	furibond
furier	furier
furieri	furier
furio	furio
furios	furios
furiosa	furios
furiosament	furiosament
furiosi	furios
furioso	furios
furka	furka
furlan	furlan
furler	furler
furlger	furlger
furman	furman
furno	furno
furonoincidenti	furonoincidenti
furonoscar	furonoscar
furor	furor
furoreggia	furoreggia
furoreggiano	furoreggiano
furori	furor
furrer	furrer
furstenberg	furstenberg
furtarello	furtarello
furth	furth
furti	furti
furtiva	furtiv
furtivament	furtivament
furtivi	furtiv
furtivo	furtiv
furto	furto
furttal	furttal
furtuna	furtuna
furuholmen	furuholmen
fururo	fururo
furusawa	furusawa
furuya	furuya
fusa	fusa
fusag	fusag
fusagasuga	fusagasuga
fusako	fusako
fusc	fusc
fuscelli	fuscell
fuscello	fuscell
fusco	fusco
fuse	fuse
fusi	fusi
fusion	fusion
fusioni	fusion
fuso	fuso
fusolier	fusolier
fusoliera	fusolier
fusong	fusong
fussbal	fussbal
fust	fust
fusti	fusti
fustig	fusti
fustigar	fustigar
fustigati	fustigat
fustigato	fustigat
fustigator	fustigator
fustigatori	fustigator
fustigazion	fustigazion
fusto	fusto
fut	fut
futami	futami
futian	futian
futil	futil
futili	futil
futilissimo	futilissimo
futilità	futilità
futiyeh	futiyeh
futon	futon
futoro	futoro
futterknecht	futterknecht
futtutu	futtutu
futur	futur
futura	futur
futuri	futur
futuribil	futuribil
futuribili	futuribil
futurismo	futurismo
futurista	futurist
futuristi	futurist
futuristica	futuristic
futuristich	futuristic
futuristico	futuristic
futuro	futur
futurologia	futurologia
futurologo	futurologo
futuroscop	futuroscop
fututo	fututo
fux	fux
fuxin	fuxin
fuzhou	fuzhou
fuzionario	fuzionario
fv	fv
fvorir	fvorir
fvrancesco	fvrancesco
fyodor	fyodor
fyodorov	fyodorov
fyrom	fyrom
fyvush	fyvush
fz	fz
fà	fà
fäh	fäh
fähndrich	fähndrich
fällanden	fällanden
fäscht	fäscht
fässler	fässler
fèete	fèete
fé	fé
fédérale	fédérale
fédération	fédération
félicien	félicien
félicin	félicin
félix	félix
fév	fév
fête	fête
föllmi	föllmi
förster	förster
füeg	füeg
führer	führer
fünfschill	fünfschill
für	für
füra	füra
fürer	fürer
fürigen	fürigen
fürst	fürst
fürstenberg	fürstenberg
fürstenland	fürstenland
fürstennberg	fürstennberg
füssli	füssli
füst	füst
g1	g1
g10	g10
g113	g113
g15	g15
g222	g222
g3	g3
g4ger	g4ger
g51	g51
g61	g61
g7	g7
g8	g8
ga	ga
gaa	gaa
gabaglio	gabaglio
gabal	gabal
gabalinskaia	gabalinskaia
gabathul	gabathul
gabbana	gabbana
gabbi	gabbi
gabbia	gabbi
gabbiani	gabbian
gabbiano	gabbian
gabbietta	gabbietta
gabbiotti	gabbiott
gabbiotto	gabbiott
gabcikovo	gabcikovo
gabe	gabe
gabel	gabel
gabella	gabella
gabellato	gabellato
gabellier	gabellier
gabellieri	gabellier
gaber	gaber
gabi	gabi
gabibbo	gabibbo
gabicc	gabicc
gabid	gabid
gabin	gabin
gabinetti	gabinett
gabinetto	gabinett
gabio	gabio
gabiow	gabio
gabirù	gabirù
gabl	gabl
gabon	gabon
gabones	gabones
gabonesi	gabones
gabor	gabor
gaboron	gaboron
gabr	gabr
gabrez	gabrez
gabri	gabri
gabriel	gabriel
gabriela	gabriel
gabrielescu	gabrielescu
gabriella	gabriell
gabrielli	gabriell
gabrovo	gabrovo
gacev	gacev
gachet	gachet
gachnang	gachnang
gaci	gaci
gaciani	gaciani
gad	gad
gadarut	gadarut
gadauta	gadauta
gaddi	gaddi
gadel	gadel
gadget	gadget
gadi	gadi
gadient	gadient
gadmen	gadme
gadmer	gadme
gador	gador
gadoufoua	gadoufoua
gadsen	gadsen
gae	gae
gaedek	gaedek
gaehwil	gaehwil
gael	gael
gaelica	gaelica
gaella	gaella
gaerner	gaerner
gaeta	gaeta
gaetan	gaetan
gaetana	gaetan
gaetano	gaetan
gafari	gafari
gaff	gaff
gafin	gafin
gafunzo	gafunzo
gag	gag
gagarin	gagarin
gagarinski	gagarinski
gagauzi	gagauzi
gage	gage
gaggini	gaggini
gaggiolo	gaggiolo
gagliard	gagliard
gagliarda	gagliard
gagliardetti	gagliardetti
gagliardi	gagliard
gagnon	gagnon
gago	gago
gahamanyi	gahamanyi
gahanes	gahanes
gahanesi	gahanes
gahanna	gahanna
gahima	gahima
gahini	gahini
gahli	gahli
gahs	gahs
gai	gai
gaia	gaia
gaiashkibo	gaiashkibo
gaidanov	gaidanov
gaidar	gaidar
gail	gail
gailani	gailani
gailat	gailat
gaili	gaili
gaillard	gaillard
gaillot	gaillot
gaiman	gaiman
gain	gain
gaina	gaina
gainesvil	gainesvil
gainsbourg	gainsbourg
gaishi	gaishi
gait	gait
gaither	gaither
gaithersburg	gaithersburg
gaito	gaito
gaitskel	gaitskel
gaiu	gaiu
gajah	gajah
gajulli	gajulli
gak	gak
gakkai	gakkai
gako	gako
gakuba	gakuba
gal	gal
gala	gala
galabey	galabey
galabeya	galabey
galabovo	galabovo
galachki	galachki
galactina	galactina
galal	galal
galan	galan
galant	galant
galantement	galantement
galanteria	galanteria
galanti	galant
galantuomo	galantuomo
galapagar	galapagar
galapago	galapago
galassi	galassi
galassia	galassi
galasso	galasso
galateo	galateo
galati	galati
galatina	galatina
galatolo	galatolo
galattici	galattici
galattorrea	galattorrea
galaxi	galaxi
galazov	galazov
galbani	galbani
galbar	galbar
galbraith	galbraith
galbright	galbright
galbu	galbu
gale	gale
galea	galea
galeano	galeano
galeao	galea
galeb	galeb
galen	galen
galenica	galenic
galenich	galenic
galeon	galeon
galeoni	galeon
galeota	galeota
galeotta	galeott
galeotti	galeott
galeotto	galeott
galep	galep
galeppini	galeppini
galer	galer
galera	galer
galeri	galer
galessi	galessi
galett	galett
galetto	galett
galfetti	galfetti
galgala	galgala
galgano	galgano
gali	gali
galic	galic
galicia	galicia
galignani	galignani
galil	galil
galilea	galile
galilei	galile
galileiana	galileiana
galileo	galile
galina	galin
galindo	galindo
galini	galin
galinski	galinski
galioto	galioto
galisteu	galisteu
galizi	galizi
galizia	galizi
galkayo	galkayo
gall	gall
galla	galla
gallagh	gallagh
galland	gallan
gallant	gallan
gallar	galla
gallaweya	gallaweya
gallaz	galla
galleggerà	galleggerà
galleggi	galleggi
galleggia	galleggia
galleggiamento	galleggiamento
galleggiando	galleggiando
galleggiano	galleggiano
galleggiant	galleggiant
galleggianti	galleggiant
galleggiar	galleggia
galleggiato	galleggiato
galleggiava	galleggiava
galleggiavano	galleggiavano
gallego	gallego
gallei	galle
galler	galle
galleri	galleri
galleria	galleri
gallerista	gallerist
galleristi	gallerist
galles	galles
gallesi	galles
gallett	gallett
galletta	gallett
galli	galli
gallianri	gallianri
galliat	galliat
gallico	gallico
gallik	galli
gallimard	gallimard
gallin	gallin
gallina	gallin
gallinacci	gallinacci
gallinari	gallinar
gallinaro	gallinar
gallio	galli
gallipoli	gallipoli
gallizioli	gallizioli
gallmeist	gallmeist
gallo	gallo
galloi	gallo
gallon	gallon
galloni	gallon
gallonisaranno	gallonisaranno
gallotti	gallotti
gallowai	gallowai
gallson	gallson
gallu	gallu
gallucci	gallucci
gallup	gallu
gallura	gallura
galmozzi	galmozzi
galo	galo
galoppa	galoppa
galoppant	galoppant
galoppanti	galoppant
galoppar	galoppa
galoppata	galoppat
galoppato	galoppat
galoppo	galoppo
galsden	galsden
galski	galski
galsov	galsov
galtellì	galtellì
galtieri	galtieri
galucci	galucci
galunggung	galunggung
galuppo	galuppo
galushko	galushko
galvagno	galvagno
galvan	galva
galvanizza	galvanizza
galvanizzanti	galvanizzanti
galvanizzar	galvanizza
galvanizzati	galvanizzat
galvanizzato	galvanizzat
galvao	galva
galverston	galverston
galveston	galveston
galvin	galvin
galwai	galwai
galya	galya
galà	galà
gam	gam
gama	gama
gamacchio	gamacchio
gamair	gamair
gamal	gamal
gamaskhurdia	gamaskhurdia
gamb	gamb
gamba	gamba
gambacorta	gambacorta
gambal	gamba
gambaletti	gambaletti
gambari	gambari
gambarogno	gambarogno
gambel	gambel
gamberal	gamberal
gamberetti	gamberett
gamberetto	gamberett
gamberi	gamber
gambero	gamber
gambi	gambi
gambia	gambi
gambian	gambian
gambiani	gambian
gambiez	gambiez
gambini	gambin
gambino	gambin
gambizzati	gambizzati
gambl	gambl
gambo	gambo
gamboni	gamboni
game	game
gamero	gamero
gameti	gameti
gamez	gamez
gamini	gamini
gamla	gamla
gamma	gamma
gammel	gammel
gamow	gamow
gamp	gamp
gampel	gampel
gampelen	gampelen
gampergalt	gampergalt
gamsakhurdia	gamsakhurdia
gamsakhuria	gamsakhuria
gamsakurdia	gamsakurdia
gamàa	gamàa
gan	gan
gana	gana
ganam	ganam
ganantir	ganantir
ganasc	ganasc
ganchev	ganchev
ganci	ganci
gancia	ganci
ganciclovir	ganciclovir
gancio	ganci
gand	gand
ganda	ganda
gandakoy	gandakoy
ganden	gande
gander	gande
gandhara	gandhara
gandhi	gandhi
gandhiano	gandhiano
gandi	gandi
gandia	gandi
gandja	gandja
gandoi	gandoi
gandolfo	gandolfo
gandosso	gandosso
gandsman	gandsman
gandusio	gandusio
ganeem	ganeem
ganei	ganei
ganes	ganes
ganesh	ganes
gang	gang
ganga	ganga
gangel	gangel
gangià	gangià
gangli	gangli
ganglio	gangli
gangnard	gangnard
gangrena	gangrena
gangsta	gangsta
gangster	gangster
gangsteristich	gangsteristich
ganguin	ganguin
gani	gani
ganic	ganic
ganim	ganim
ganiram	ganiram
ganja	ganja
gannaio	gannaio
gannett	gannett
gannio	gannio
gannon	gannon
gansel	gansel
gansser	gansser
gansu	gansu
gantamarov	gantamarov
gantamirov	gantamirov
gantanamo	gantanamo
gantemirov	gantemirov
ganter	ganter
gantin	gantin
gantri	gantri
gantt	gantt
gantz	gantz
ganz	ganz
ganò	ganò
gao	gao
gaolin	gaolin
gaon	gaon
gap	gap
gar	gar
gara	gara
garaci	garaci
garag	garag
garagista	garagist
garagisti	garagist
garai	garai
garaldo	garaldo
garang	garang
garanitsc	garanitsc
garanntito	garanntito
garant	garant
garantendo	garantendo
garantendon	garantendo
garantendosi	garantendosi
garanti	garanti
garantia	garanti
garantiamo	garantiamo
garantir	garantir
garantiranno	garantiranno
garantirci	garantirci
garantirebb	garantirebb
garantirebbero	garantirebbero
garantiremo	garantiremo
garantirgli	garantirgli
garantirl	garantirl
garantirla	garantirl
garantirlo	garantirl
garantirn	garantir
garantirsi	garantirsi
garantirvi	garantirvi
garantirà	garantir
garantisc	garantisc
garantisca	garantisc
garantiscano	garantiscano
garantisco	garantisco
garantiscono	garantiscono
garantiscoö	garantisco
garantiss	garantiss
garantist	garantist
garantista	garantist
garantisti	garantist
garantit	garantit
garantita	garantit
garantito	garantit
garantità	garantit
garantiva	garantiva
garantivano	garantivano
garantì	garant
garanuzia	garanuzia
garanzi	garanzi
garanzia	garanzi
garatisc	garatisc
garattini	garattini
garaudi	garaudi
garavaglia	garavaglia
garavini	garavini
garbad	garbad
garbarino	garbarino
garbatella	garbatella
garbati	garbat
garbato	garbat
garben	garben
garberoglio	garberoglio
garbino	garbino
garbo	garbo
garboli	garboli
garbu	garbu
garbuglio	garbuglio
garca	garca
garcetti	garcetti
garchitorena	garchitorena
garcia	garci
garcin	garci
gard	gard
garda	garda
gardar	garda
gardelegen	gardelegen
gardemoen	gardemoen
garden	garden
gardena	garden
gardermoen	gardermoen
gardin	gardin
gardini	gardin
gardiol	gardiol
gardner	gardner
gardon	gardo
gardov	gardo
garduno	garduno
gare	gare
gareggia	gareggia
gareggiando	gareggiando
gareggiar	gareggia
gareggiava	gareggiava
garel	garel
garessio	garessio
gareth	gareth
garethi	gareth
garfa	garfa
garfagnana	garfagnana
garfein	garfein
garfield	garfield
garg	garg
gargallo	gargallo
garganico	garganico
gargano	gargano
gargantini	gargantini
gari	gari
garibaldi	garibaldi
garibaldin	garibaldin
garibaldini	garibaldin
garibaldino	garibaldin
gariboldi	gariboldi
garidi	garidi
garidov	garidov
garimberti	garimberti
garimpeiro	garimpeiro
garimpo	garimpo
garinei	garinei
garino	garino
garissa	garissa
garitta	garitta
garland	garland
garlasco	garlasco
garm	garm
garma	garma
garmaba	garmaba
garmisch	garmisch
garmit	garmit
garmond	garmond
garn	garn
garnat	garnat
garnd	garnd
garner	garner
garnet	garnet
garnett	garnet
garnier	garnier
garntir	garntir
garo	garo
garofalo	garofalo
garofan	garofan
garofani	garofan
garofano	garofan
garonn	garonn
garota	garota
garrafa	garrafa
garran	garran
garrani	garran
garrard	garrard
garret	garret
garretta	garrett
garretto	garrett
garri	garri
garrido	garrido
garrigu	garrigu
garrir	garri
garrison	garrison
garritta	garritta
garriva	garriva
garrot	garrot
garrota	garrot
garrott	garrot
garruzzo	garruzzo
garten	garten
gartenbau	gartenbau
garth	garth
gartmann	gartmann
garu	garu
garuzzo	garuzzo
garvagh	garvagh
garvei	garvei
garvera	garvera
garza	garza
garzanti	garzanti
garzarelli	garzarelli
garzon	garzon
gasan	gasan
gasana	gasan
gasanov	gasanov
gasata	gasata
gasca	gasca
gasch	gasch
gasdia	gasdia
gasdotti	gasdott
gasdotto	gasdott
gasetta	gasetta
gasiera	gasiera
gasiev	gasiev
gasinci	gasinci
gasinzi	gasinzi
gasiorowski	gasiorowski
gasiunov	gasiunov
gaslini	gaslini
gasodotti	gasodotti
gasolio	gasolio
gaspar	gaspar
gaspard	gaspar
gaspari	gaspar
gasparini	gasparini
gasparov	gasparov
gasparri	gasparr
gasparro	gasparr
gaspart	gaspar
gasperi	gasperi
gaspip	gaspip
gaspoz	gaspoz
gaspra	gaspra
gasprom	gasprom
gassan	gassan
gassat	gassat
gassata	gassat
gassenzimm	gassenzimm
gasser	gasser
gasseriano	gasseriano
gassificazion	gassificazion
gassman	gassman
gassmann	gassman
gassner	gassner
gassos	gassos
gassosa	gassos
gassoso	gassos
gast	gast
gastarbeit	gastarbeit
gastaud	gastau
gastaut	gastau
gasteyg	gasteyg
gastin	gastin
gaston	gaston
gastrica	gastric
gastrici	gastric
gastrico	gastric
gastro	gastro
gastroenterici	gastroenterici
gastroenterit	gastroenterit
gastrointerit	gastrointerit
gastrointestinal	gastrointestinal
gastrointestinali	gastrointestinal
gastronimia	gastronimia
gastronomi	gastronomi
gastronomia	gastronomi
gastronomica	gastronomic
gastronomich	gastronomic
gastronomici	gastronomic
gastronomico	gastronomic
gastronomo	gastronomo
gastroscopia	gastroscopia
gastuad	gastuad
gasö	gasö
gat	gat
gata	gata
gatabazi	gatabazi
gatashya	gatashya
gate	gate
gatemouth	gatemouth
gatenga	gatenga
gateo	gateo
gatewai	gatewai
gatlei	gatlei
gato	gato
gatow	gatow
gatsbi	gatsbi
gatsha	gatsha
gatsinzi	gatsinzi
gatt	gatt
gatta	gatta
gattegno	gattegno
gatti	gatti
gattik	gatti
gattikon	gattikon
gattina	gattin
gattinara	gattinara
gattini	gattin
gattino	gattin
gattlex	gattlex
gatto	gatto
gatton	gatto
gattonar	gattonar
gattopardi	gattopard
gattopardo	gattopard
gattopardò	gattopard
gatward	gatward
gatwick	gatwick
gau	gau
gaubillard	gaubillard
gauch	gauch
gauchist	gauchist
gauchista	gauchist
gauchisti	gauchist
gauck	gauck
gaudal	gaudal
gaudata	gaudata
gaudent	gaudent
gaudenti	gaudent
gaudenz	gaudenz
gaudenzi	gaudenz
gauderon	gauderon
gaudin	gaudi
gaudio	gaudi
gaudioso	gaudioso
gauffin	gauffin
gauffr	gauffr
gaugin	gaugin
gauguin	gauguin
gaujac	gaujac
gauler	gauler
gauli	gauli
gaull	gaull
gauna	gauna
gaurdi	gaurdi
gautemaltech	gautemaltech
gauthier	gauthier
gautier	gautier
gauto	gauto
gautrelet	gautrelet
gauwail	gauwail
gauweil	gauweil
gava	gava
gavati	gavati
gavazzeni	gavazzeni
gavazzi	gavazzi
gaveau	gaveau
gavett	gavett
gavetta	gavett
gavianea	gavianea
gavin	gavin
gavino	gavin
gaviria	gaviria
gavon	gavon
gavra	gavra
gavrankapetanov	gavrankapetanov
gavrankapetranov	gavrankapetranov
gavriel	gavriel
gavriil	gavriil
gavrikov	gavrikov
gavrilo	gavrilo
gavroch	gavroch
gawronski	gawronski
gay	gay
gaya	gaya
gayant	gayant
gayot	gayot
gayyid	gayyid
gaz	gaz
gaza	gaza
gazankulu	gazankulu
gazebi	gazebi
gazel	gazel
gazeta	gazet
gazett	gazet
gazi	gazi
gaziantep	gaziantep
gazieta	gazieta
gazit	gazit
gazmararian	gazmararian
gazmash	gazmash
gazmuri	gazmuri
gazoldo	gazoldo
gazprom	gazprom
gazz	gazz
gazzara	gazzara
gazzarra	gazzarra
gazzel	gazzel
gazzella	gazzella
gazzeri	gazzeri
gazzetta	gazzetta
gazzettino	gazzettino
gazzosa	gazzosa
gaëll	gaëll
gaïd	gaïd
gb	gb
gbadolit	gbadolit
gbagbo	gbagbo
gbarnga	gbarnga
gbb	gbb
gbeho	gbeho
gbeny	gbeny
gbolahan	gbolahan
gbr	gbr
gbt	gbt
gc	gc
gcc	gcc
gchq	gchq
gci	gci
gcp	gcp
gcse	gcse
gcv	gcv
gd	gd
gded	gded
gdf	gdf
gdi	gdi
gdl	gdl
gdynia	gdynia
ge	ge
gea	gea
geagea	geagea
gearan	gearan
gearen	gearen
gearhard	gearhard
geavaert	geavaert
gebbi	gebbi
gebe	gebe
gebenstorf	gebenstorf
geberit	geberit
gebhard	gebhard
gebhardt	gebhard
gebhart	gebhart
gebhrart	gebhrart
gebr	gebr
gebran	gebran
gebrauch	gebrauch
gebreselassi	gebreselassi
gec	gec
gedda	gedda
gedeon	gedeon
gedik	gedik
gedo	gedo
gedr	gedr
geduld	geduld
gee	gee
geel	geel
geelmuyden	geelmuyden
geen	geen
geeneral	geeneral
geenral	geenral
geer	geer
gef	gef
geffen	geffe
geffer	geffe
gefipro	gefipro
gegen	gegen
gegenzhao	gegenzhao
gegprifti	gegprifti
geha	geha
gehin	gehin
gehla	gehla
gehlen	gehlen
gehr	gehr
gehrard	gehrard
gehrashenko	gehrashenko
gehrck	gehrck
gehri	gehri
gehrig	gehri
gei	gei
geiger	geiger
geigi	geigi
geiko	geiko
geiling	geiling
geir	geir
geisenheim	geisenheim
geiser	geiser
geish	geish
geisha	geish
geishato	geishato
geisman	geisman
geiss	geiss
geisser	geisser
geissler	geissler
geissmann	geissmann
geissstrass	geissstrass
geistlich	geistlich
geitling	geitling
gejdenson	gejdenson
gel	gel
gela	gela
gelao	gelao
gelar	gelar
gelat	gelat
gelata	gelat
gelataio	gelataio
gelateri	gelateri
gelateria	gelateri
gelati	gelat
gelatin	gelatin
gelatina	gelatin
gelatinasi	gelatinasi
gelatinosa	gelatinos
gelatinoso	gelatinos
gelato	gelat
gelava	gelava
gelax	gelax
gelbard	gelbar
gelbart	gelbar
geld	geld
gelder	gelder
geldermalsen	geldermalsen
geldof	geldof
geleng	geleng
gelesi	gelesi
gelfand	gelfand
geli	geli
gelibt	gelibt
gelid	gelid
gelida	gelid
gelidament	gelidament
gelidi	gelid
gelido	gelid
gelificata	gelificata
gelikhanov	gelikhanov
gelino	gelino
gellabia	gellabia
geller	geller
gelli	gelli
gellman	gellman
gelo	gelo
gelos	gelos
gelosa	gelos
gelosament	gelosament
gelosi	gelosi
gelosia	gelosi
gelosissima	gelosissim
gelosissimo	gelosissim
geloso	gelos
gelovian	gelovian
gelsei	gelsei
gelsenkirchen	gelsenkirchen
gelsomina	gelsomin
gelsomini	gelsomin
gelterkinden	gelterkinden
geltz	geltz
gemania	gemania
gemar	gemar
gemayel	gemayel
gemeentemuseum	gemeentemuseum
gemeinhardt	gemeinhardt
gemel	gemel
gemella	gemell
gemellaggio	gemellaggio
gemellar	gemellar
gemellari	gemellar
gemellarsi	gemellarsi
gemellata	gemellata
gemelli	gemell
gemello	gemell
gemendo	gemendo
gemina	gemin
gemini	gemin
gemisto	gemisto
gemiti	gemit
gemito	gemit
gemm	gemm
gemma	gemma
gemmi	gemmi
gemonio	gemonio
gemperli	gemperli
gemrusa	gemrusa
gemsstock	gemsstock
gemunu	gemunu
gen	gen
genadij	genadij
genadiju	genadij
genaio	genaio
genarel	genarel
genaro	genaro
genc	genc
genco	genco
gencor	genco
gendai	gendai
gendarm	gendarm
gendarmenmarkt	gendarmenmarkt
gendarmeri	gendarmeri
gendarmeria	gendarmeri
gendarmi	gendarm
gendr	gendr
gendun	gendun
gene	gene
geneal	geneal
genealogica	genealogic
genealogico	genealogic
genealogisti	genealogisti
genear	genear
genearl	genear
genentech	genentech
geneocidio	geneocidio
gener	gener
genera	genera
general	general
generala	general
generalessa	generalessa
generali	general
generaliseé	generaliseé
generalisimo	generalisimo
generalissimo	generalissimo
generalista	generalista
generalità	generalità
generalizia	generalizia
generalizz	generalizz
generalizza	generalizza
generalizzando	generalizzando
generalizzar	generalizza
generalizzarsi	generalizzarsi
generalizzata	generalizzat
generalizzati	generalizzat
generalizzato	generalizzat
generalizzazion	generalizzazion
generalizzazioni	generalizzazion
generalment	generalment
generalmentr	generalment
generalé	general
generando	generando
generano	generano
generar	genera
generarsi	generarsi
generata	generat
generati	generat
generativi	generativ
generativo	generativ
generato	generat
generator	generator
generatori	generator
generatrici	generatrici
generazion	generazion
generazional	generazional
generazionali	generazional
generazioni	generazion
generel	generel
genereranno	genereranno
genererebb	genererebb
genererà	genererà
generi	gener
generica	generic
genericament	genericament
generich	generic
generici	generic
genericità	genericità
generico	generic
generino	generino
generlment	generlment
genero	gener
generos	generos
generosa	generos
generosament	generosament
generosi	generos
generosità	generosità
generoso	generos
genesi	genesi
genesisland	genesisland
genestrerio	genestrerio
genet	genet
genetech	genetech
genetica	genetic
geneticament	geneticament
genetich	genetic
genetici	genetic
genetico	genetic
genetista	genetista
genetliaco	genetliaco
genev	genev
geneva	genev
geneviev	geneviev
genevièv	genevièv
genevoi	genevoi
genevois	genevoi
genevoix	genevoi
genevra	genevra
genezaret	genezaret
genf	genf
gengarelli	gengarelli
gengi	gengi
gengiv	gengi
geni	geni
genial	genial
geniali	genial
genialità	genialità
genich	genic
genico	genic
genieri	genieri
geninasca	geninasca
genio	genio
genis	genis
genital	genital
genitali	genital
genitor	genitor
genitori	genitor
genitric	genitric
geniu	geniu
genmelli	genmelli
gennadi	gennadi
gennaio	gennaio
gennario	gennario
gennaro	gennaro
gennep	gennep
genni	genni
genniao	genniao
gennif	genni
gennio	genni
gennnaio	gennnaio
geno	geno
genoa	genoa
genocida	genocida
genocidi	genocidi
genocidio	genocidi
genoma	genoma
genoroso	genoroso
genosseschaft	genosseschaft
genotipo	genotipo
genoud	genoud
genov	genov
genova	genov
genoves	genoves
genovesi	genoves
genpharm	genpharm
genral	genral
genralizzato	genralizzato
genreal	genreal
genrietta	genrietta
genscher	genscher
genshagen	genshagen
gensuikin	gensuikin
gensuikyo	gensuikyo
gent	gent
genta	genta
gentepregava	gentepregava
genti	genti
gentil	gentil
gentilcor	gentilcor
gentilezza	gentilezza
gentili	gentil
gentilini	gentilini
gentilizia	gentilizia
gentilli	gentilli
gentilment	gentilment
gentiloni	gentiloni
gentiluomini	gentiluomini
gentiluomo	gentiluomo
gentium	gentium
gentleman	gentleman
gentlemen	gentlemen
genuflessa	genufless
genuflessi	genufless
genuflesso	genufless
genuin	genuin
genuina	genuin
genuinament	genuinament
genuinamewnt	genuinamewnt
genuini	genuin
genuinità	genuinità
genuino	genuin
genunina	genunina
genzym	genzym
genèv	genèv
genèviev	genèviev
geo	geo
geoan	geoan
geoana	geoan
geodesia	geodesia
geodesich	geodesich
geodinamica	geodinamic
geodinamico	geodinamic
geoff	geoff
geoffrei	geoffrei
geofica	geofica
geofisica	geofisic
geofisici	geofisic
geofisico	geofisic
geofisika	geofisika
geofizika	geofizika
geoghagan	geoghagan
geoghegan	geoghegan
geografi	geografi
geografia	geografi
geografica	geografic
geograficament	geograficament
geografich	geografic
geografici	geografic
geografico	geografic
geografiucament	geografiucament
geografo	geografo
geograph	geograph
geolog	geolog
geologi	geologi
geologia	geologi
geologica	geologic
geologicament	geologicament
geologich	geologic
geologici	geologic
geologico	geologic
geologo	geolog
geomagnetico	geomagnetico
geometra	geometra
geometri	geometri
geometria	geometri
geometrica	geometric
geometrich	geometric
geometrici	geometric
geometrico	geometric
geomorfologo	geomorfologo
geopardizzato	geopardizzato
geopolitca	geopolitca
geopolitica	geopolitic
geopolitich	geopolitic
geopolitici	geopolitic
geopolitico	geopolitic
georg	georg
georga	georg
georgetown	georgetown
georghi	georghi
georghiad	georghiad
georgi	georgi
georgia	georgi
georgiad	georgiad
georgiadi	georgiad
georgian	georgian
georgiana	georgian
georgiani	georgian
georgiano	georgian
georgievski	georgievski
georgij	georgi
georgijevski	georgijevski
georgina	georgina
georgio	georgi
georgiyevna	georgiyevna
georgjievski	georgjievski
georgofili	georgofili
georgrafica	georgrafic
georgrafich	georgrafic
georgrafici	georgrafic
georgrafico	georgrafic
geosat	geosat
geosincron	geosincron
geostationari	geostationari
geostazionari	geostazionari
geostazionaria	geostazionari
geostrategica	geostrategica
geotecnico	geotecnico
geotermica	geotermic
geotermich	geotermic
geotropoli	geotropoli
geova	geova
gephard	gephard
gephardt	gephard
ger	ger
gera	gera
gerac	gerac
gerachenko	gerachenko
gerachia	gerachia
geraci	gerac
gerado	gerado
geraghti	geraghti
gerai	gerai
geral	geral
gerald	gerald
geralda	gerald
geraldin	geraldin
geraldini	geraldin
geraldo	gerald
gerani	gerani
gerarachico	gerarachico
gerarca	gerarca
gerarchi	gerarchi
gerarchia	gerarchi
gerarchica	gerarchic
gerarchicament	gerarchicament
gerarchich	gerarchic
gerarchici	gerarchic
gerarchico	gerarchic
gerarchizzazion	gerarchizzazion
gerarcia	gerarcia
gerard	gerard
gerardelli	gerardelli
gerardina	gerardina
gerardo	gerard
gerascenko	gerascenko
geraschenko	geraschenko
geraschtschenko	geraschtschenko
gerashenko	gerashenko
gerasimo	gerasimo
gerasimov	gerasimo
gerasolo	gerasolo
gerassimo	gerassimo
gerassimof	gerassimo
gerba	gerba
gerber	gerber
gerco	gerco
gerd	gerd
gerda	gerda
gere	gere
gerean	gerean
gereb	gereb
geremek	geremek
geren	geren
gerenericament	gerenericament
gerent	gerent
gerenti	gerent
gerenza	gerenza
gereral	gereral
gereshom	gereshom
gereti	gereti
gerettet	gerettet
gergen	gergen
gerghi	gerghi
gergo	gergo
gerhard	gerhard
gerhardt	gerhard
gerhart	gerhart
geri	geri
geriatria	geriatria
geriatrich	geriatric
geriatrici	geriatric
geriatrico	geriatric
geric	geric
gerico	geric
geritz	geritz
gerl	gerl
gerlafingen	gerlafingen
gerlanc	gerlanc
gerlando	gerlando
gerlikon	gerlikon
gerlsenkirchen	gerlsenkirchen
germ	germ
germain	germain
german	german
germana	german
germani	germani
germania	germania
germaniadalla	germaniadalla
germaniaú	germania
germanica	germanic
germanich	germanic
germanici	germanic
germanico	germanic
germanio	germani
germanista	germanista
germanistica	germanistica
germanizzar	germanizzar
germanizzata	germanizzata
germann	german
germano	german
germanofona	germanofon
germanofoni	germanofon
germanofono	germanofon
germersheim	germersheim
germi	germi
germignaga	germignaga
germin	germin
germinal	germinal
germini	germin
germiston	germiston
germogli	germogli
germoglia	germogli
germoglio	germogli
germoplasma	germoplasma
gero	gero
gerodswil	gerodswil
gerogia	gerogia
geroglifica	geroglific
geroglifici	geroglific
geroglifico	geroglific
gerolag	gerolag
gerolamo	gerolamo
gerold	gerold
geroldswil	geroldswil
gerona	gerona
geronimo	geronimo
gerontologia	gerontologia
gerosa	gerosa
gerosolimitani	gerosolimitani
gerra	gerra
gerri	gerri
gerrit	gerri
gerrra	gerrra
gersalemm	gersalemm
gersau	gersau
gerschwil	gerschwil
gershwin	gershwin
gerson	gerson
gersoni	gerson
gerster	gerster
gerstl	gerstl
gerstner	gerstner
gersualemm	gersualemm
gert	gert
gertjan	gertjan
gertrud	gertrud
gertruda	gertrud
gertschen	gertschen
gerualemm	gerualemm
geruasalemm	geruasalemm
gerula	gerula
gerusaelemm	gerusaelemm
gerusaemm	gerusaemm
gerusalem	gerusalem
gerusalemm	gerusalemm
gerusalemmm	gerusalemm
gerusalenmm	gerusalenmm
gerusalmm	gerusalmm
gerusasalemm	gerusasalemm
gervai	gervai
gervais	gervai
gesamtmetal	gesamtmetal
gescher	gescher
geschicht	geschicht
gesellschaft	gesellschaft
geser	geser
gesingen	gesingen
gesira	gesira
gespar	gespar
gesparel	gesparel
gessa	gessa
gessato	gessato
gessatori	gessatori
gessetto	gessetto
gessner	gessner
gessneralle	gessneralle
gesso	gesso
gesta	gesta
gestacci	gestacci
gestaltung	gestaltung
gestant	gestant
gestanti	gestant
gestapo	gestapo
gestazion	gestazion
gestazioni	gestazion
gestendo	gestendo
gester	gester
gesti	gesti
gestibil	gestibil
gestibili	gestibil
gestic	gesti
gesticolar	gesticolar
gesticolato	gesticolato
gesticono	gesticono
gestinon	gestinon
gestion	gestion
gestional	gestional
gestionali	gestional
gestioni	gestion
gestir	gestir
gestiranno	gestiranno
gestirano	gestirano
gestirl	gestirl
gestirli	gestirl
gestirlo	gestirl
gestirsi	gestirsi
gestirà	gestir
gestisc	gestisc
gestisca	gestisc
gestiscono	gestiscono
gestiss	gestiss
gestit	gestit
gestita	gestit
gestiti	gestit
gestito	gestit
gestiusc	gestiusc
gestiva	gestiva
gestivano	gestivano
gestner	gestner
gesto	gesto
gestohlen	gestohlen
gestor	gestor
gestori	gestor
gestual	gestual
gestì	gestì
gesu	gesu
gesualdo	gesualdo
gesuita	gesuit
gesuiti	gesuit
gesuitico	gesuitico
gesunda	gesunda
gesundheit	gesundheit
gesundheitsreform	gesundheitsreform
gesù	gesù
getachew	getachew
getahun	getahun
getra	getra
getrud	getrud
getsemani	getsemani
getta	getta
gettabil	gettabil
gettando	gettando
gettandol	gettandol
gettandola	gettandol
gettandoli	gettandol
gettandolo	gettandol
gettandon	gettando
gettandosi	gettandosi
gettandovi	gettandovi
gettano	gettano
gettar	getta
gettarl	gettarl
gettarla	gettarl
gettarli	gettarl
gettarlo	gettarl
gettarono	gettarono
gettarsi	gettarsi
gettarvi	gettarvi
gettat	gettat
gettata	gettat
gettati	gettat
gettato	gettat
gettava	gettava
gettavano	gettavano
getteranno	getteranno
getterebb	getterebb
getterebbero	getterebbero
getterà	getterà
getti	getti
gettiamo	gettiamo
gettino	gettino
gettiti	gettit
gettito	gettit
getto	getto
getton	getton
gettonata	gettonat
gettonati	gettonat
gettonato	gettonat
gettoni	getton
gettonier	gettonier
gettysburg	gettysburg
gettò	gettò
getulio	getulio
getz	getz
geuenich	geuenich
geul	geul
geurra	geurra
gev	gev
gew	gew
gewaltfrei	gewaltfrei
gewerbebank	gewerbebank
gex	gex
geysel	geysel
geza	geza
gf	gf
gfbv	gfbv
gfeller	gfeller
gfk	gfk
gfm	gfm
gfssla	gfssla
gft	gft
ggb	ggb
ggi	ggi
ggk	ggk
ggolan	ggolan
ggt	ggt
gh	gh
ghabe	ghabe
ghabid	ghabid
ghadib	ghadib
ghaemshar	ghaemshar
ghaffar	ghaffar
ghaicciaio	ghaicciaio
ghaleb	ghaleb
ghali	ghali
ghamra	ghamr
ghamri	ghamr
ghana	ghana
ghanaian	ghanaian
ghanayem	ghanayem
ghandi	ghandi
ghanem	ghanem
ghanemi	ghanem
ghanes	ghanes
ghanesi	ghanes
ghani	ghani
ghannouchi	ghannouchi
ghanouchi	ghanouchi
gharb	gharb
gharbi	gharb
gharekhan	gharekhan
gharib	gharib
ghariba	gharib
ghassan	ghassan
ghaydhah	ghaydhah
ghazal	ghazal
ghazaleh	ghazaleh
ghazawi	ghazawi
ghazi	ghazi
ghaziabad	ghaziabad
ghazouani	ghazouani
ghebo	ghebo
ghedassi	ghedassi
gheddafi	gheddafi
gheddai	gheddai
ghedi	ghedi
ghedir	ghedi
gheidar	gheidar
ghekhi	ghekhi
ghelfi	ghelfi
gheliskhanov	gheliskhanov
ghencea	ghencea
ghenihovski	ghenihovski
ghennadi	ghennadi
gheorgh	gheorgh
gheorghi	gheorghi
gheorghiad	gheorghiad
gheorghio	gheorghi
gheorghiu	gheorghi
gheorgho	gheorgh
gheorgo	gheorgo
ghera	ghera
gheranboisk	gheranboisk
gherard	gherard
gherardesca	gherardesca
gherardo	gherard
gherascenko	gherascenko
gheraschenko	gheraschenko
gherashcenko	gherashcenko
gherashchenko	gherashchenko
gherashenko	gherashenko
gherassimo	gherassimo
gherassov	gherassov
gherlitz	gherlitz
gherman	gherman
ghermir	ghermir
ghermito	ghermito
ghermì	ghermì
ghetti	ghett
ghettizzar	ghettizzar
ghettizzazion	ghettizzazion
ghetto	ghett
ghetz	ghetz
gheula	gheula
ghez	ghez
ghezira	ghezira
ghezzi	ghezz
ghezzo	ghezz
ghi	ghi
ghia	ghia
ghiacci	ghiacci
ghiacciai	ghiacciai
ghiacciaio	ghiacciai
ghiacciat	ghiacciat
ghiacciata	ghiacciat
ghiacciatisi	ghiacciatisi
ghiacciato	ghiacciat
ghiaccio	ghiacci
ghiaccioli	ghiacciol
ghiacciolo	ghiacciol
ghiaia	ghiaia
ghiandol	ghiandol
ghiandola	ghiandola
ghiandolar	ghiandola
ghiangia	ghiangia
ghibadulin	ghibadulin
ghicha	ghicha
ghidella	ghidella
ghielmetti	ghielmetti
ghielmi	ghielmi
ghiglion	ghiglion
ghigliottin	ghigliottin
ghigliottina	ghigliottina
ghigliottinar	ghigliottina
ghigliottinata	ghigliottinat
ghigliottinati	ghigliottinat
ghigliottinato	ghigliottinat
ghigliottineremo	ghigliottineremo
ghignato	ghignato
ghigno	ghigno
ghigorov	ghigorov
ghihinun	ghihinun
ghilad	ghilad
ghilardotti	ghilardotti
ghile	ghile
ghilon	ghilon
ghine	ghine
ghion	ghion
ghiora	ghiora
ghiott	ghiott
ghiotta	ghiott
ghiotti	ghiott
ghiotto	ghiott
ghiottoneri	ghiottoneri
ghiottoneria	ghiottoneri
ghira	ghira
ghirardelli	ghirardelli
ghirelli	ghirelli
ghiribizzo	ghiribizzo
ghirigori	ghirigori
ghiringhelli	ghiringhelli
ghirlanda	ghirlanda
ghirma	ghirma
ghiro	ghiro
ghisa	ghisa
ghislain	ghislain
ghisletta	ghisletta
ghisolfa	ghisolfa
ghisonaccia	ghisonaccia
ghitarrista	ghitarrist
ghitarristi	ghitarrist
ghitit	ghitit
ghitti	ghitti
ghiumri	ghiumri
ghivarello	ghivarello
ghizlan	ghizlan
ghnaim	ghnaim
ghobbara	ghobbara
ghoch	ghoch
ghoché	ghoch
ghoergh	ghoergh
gholam	gholam
gholamreza	gholamreza
ghom	ghom
ghoraib	ghoraib
ghosh	ghosh
ghosheh	ghosheh
ghoshi	ghosh
ghossein	ghossein
ghost	ghost
ghostwrit	ghostwrit
ghota	ghota
ghoul	ghoul
ghoush	ghoush
ghousheh	ghousheh
ghozali	ghozali
ghrol	ghrol
ghulam	ghulam
ghulaman	ghulaman
ghuneim	ghuneim
ghunuriya	ghunuriya
ghusha	ghusha
gi	gi
gia	gia
giaba	giaba
giabal	giaba
giac	giac
giacarta	giacarta
giacca	giacca
giacch	giacch
giacchetta	giacchetta
giacchè	giacch
giacché	giacch
giacciono	giacciono
giaccon	giaccon
giacenti	giacenti
giacenz	giacenz
giacenza	giacenz
giacer	giacer
giacerai	giacerai
giaceva	giaceva
giacevano	giacevano
giachem	giachem
giachetti	giachetti
giacigli	giacigli
giaciglio	giacigli
giacimenti	giaciment
giacimento	giaciment
giacinto	giacinto
giaciuto	giaciuto
giacob	giacob
giacobb	giacob
giacobina	giacobin
giacobini	giacobin
giacobino	giacobin
giacomelli	giacomelli
giacometti	giacometti
giacomo	giacomo
giacomoni	giacomoni
giacosa	giacosa
giacovazzo	giacovazzo
giad	giad
giada	giada
giaffa	giaffa
giaguari	giaguar
giaguaro	giaguar
giairo	giairo
giakarta	giakarta
gialalassi	gialalassi
giall	giall
gialla	giall
giallastra	giallastr
giallastri	giallastr
giallastro	giallastr
gialli	giall
giallo	giall
giallognolo	giallognolo
giallombardo	giallombardo
giallombrado	giallombrado
giallorossi	giallorossi
giamaica	giamaica
giamaican	giamaican
giamaicana	giamaican
giamaicani	giamaican
giamaicano	giamaican
giamlet	giamlet
giammusso	giammusso
giampaolo	giampaolo
giampapa	giampapa
giampiero	giampiero
giampietro	giampietro
giamra	giamra
gian	gian
gianadda	gianadda
gianadelio	gianadelio
gianandrea	gianandrea
gianbologna	gianbologna
giancarlo	giancarlo
gianco	gianco
giancola	giancola
giandomenico	giandomenico
gianella	gianella
gianfanco	gianfanco
gianfilippo	gianfilippo
gianfraco	gianfraco
gianfranco	gianfranco
gianfreda	gianfred
gianfredo	gianfred
gianfrnaco	gianfrnaco
giangiacomo	giangiacomo
giangreco	giangreco
gianguido	gianguido
gianicolo	gianicolo
gianini	gianini
gianlorenzo	gianlorenzo
gianluca	gianluca
gianluigi	gianluigi
gianmarco	gianmarco
gianmaria	gianmaria
gianmauro	gianmauro
gianna	giann
giannelli	giannelli
giannetto	giannetto
gianni	giann
giannico	giannico
giannina	giannin
giannini	giannin
giannino	giannin
gianniotti	gianniotti
giannotti	giannotti
giano	giano
gianoli	gianoli
gianpiero	gianpiero
gianstefano	gianstefano
giant	giant
gianvittor	gianvittor
giao	giao
giap	giap
giapon	giapon
giapones	giapones
giappgn	giappgn
giappon	giappon
giappones	giappones
giapponesi	giappones
giapponesì	giappones
giapponnes	giapponnes
giappoon	giappoon
giapppon	giapppon
giapppones	giapppones
giappponesi	giapppones
giaquinto	giaquinto
giardina	giardin
giardinaggio	giardinaggio
giardinetti	giardinett
giardinetto	giardinett
giardini	giardin
giardinier	giardinier
giardiniera	giardinier
giardinieri	giardinier
giardino	giardin
giarrettier	giarrettier
giarrettiera	giarrettier
giat	giat
giava	giava
giavad	giava
giavellotto	giavellotto
gib	gib
gibail	gibail
gibb	gibb
gibbon	gibbon
gibboni	gibbon
gibeau	gibeau
gibern	gibern
gibilterra	gibilterra
gibson	gibson
gibuti	gibuti
gic	gic
gico	gico
gicocattoli	gicocattoli
gida	gida
gide	gide
gideon	gideon
gidic	gidic
gidir	gidir
gidiziaria	gidiziaria
gie	gie
gielgud	gielgud
gien	gien
giergia	giergia
gieri	gieri
giesbert	giesbert
giesc	giesc
gieseck	gieseck
giessbach	giessbach
giessen	giessen
giezendann	giezendann
gifa	gifa
gifco	gifco
giffen	giffen
gifford	gifford
gifhorn	gifhorn
gigabyt	gigabyt
gigaelettronvolt	gigaelettronvolt
gigaflop	gigaflop
gigant	gigant
giganteggia	giganteggia
gigantesca	gigantesc
gigantesch	gigantesch
giganteschi	gigantesch
gigantesco	gigantesc
giganti	gigant
gigantismo	gigantismo
gigantografi	gigantografi
gigantografia	gigantografi
giger	giger
gigi	gigi
gigio	gigio
gigionismo	gigionismo
gigiri	gigiri
gigli	gigli
giglia	gigli
giglielmo	giglielmo
giglio	gigli
gign	gign
gigno	gigno
gigolo	gigolo
gigolph	gigolph
gigorov	gigorov
giguèr	giguèr
giitwa	giitwa
gij	gij
gijini	gijini
gijon	gijon
gikhar	gikhar
gikingoro	gikingoro
gikondo	gikondo
gikongolo	gikongolo
gikongoro	gikongoro
gikoro	gikoro
gikundo	gikundo
gil	gil
gila	gila
gilan	gilan
gilardeau	gilardeau
gilardelli	gilardelli
gilardi	gilardi
gilardini	gilardini
gilbei	gilbei
gilbert	gilbert
gilberti	gilbert
gilberto	gilbert
gilchrist	gilchrist
gilda	gilda
gildenhorn	gildenhorn
gildin	gildin
gildo	gildo
gile	gile
gilfri	gilfri
gilgen	gilgen
giliti	giliti
gill	gill
gilla	gilla
gillespi	gillespi
gillett	gillett
gilli	gilli
gillial	gillia
gilliam	gillia
gillian	gillian
gilliand	gillian
gilliat	gillia
gillibert	gillibert
gillick	gillick
gilliéron	gilliéron
gillmeier	gillmeier
gillo	gillo
gillon	gillo
gillooli	gillooli
gillyard	gillyard
gilman	gilman
gilmor	gilmor
gilmour	gilmour
giloian	giloian
gilour	gilour
gilroi	gilroi
gimbel	gimbel
gimignano	gimignano
gin	gin
gina	gina
ginbar	ginbar
ginecolo	ginecolo
ginecolog	ginecolog
ginecologa	ginecolog
ginecologh	ginecolog
ginecologia	ginecologia
ginecologica	ginecologic
ginecologici	ginecologic
ginecologico	ginecologic
ginecologo	ginecolog
ginegoloco	ginegoloco
ginepraio	ginepraio
ginera	ginera
ginerino	ginerino
ginervina	ginervina
ginervra	ginervra
ginestr	ginestr
ginestra	ginestr
ginesu	ginesu
ginett	ginett
ginevr	ginevr
ginevra	ginevr
ginevrin	ginevrin
ginevrina	ginevrin
ginevrini	ginevrin
ginevrino	ginevrin
ginevriva	ginevriva
ginevrà	ginevr
ginger	ginger
gingilli	gingill
gingillo	gingill
gingiolia	gingiolia
gingolph	gingolph
gingrich	gingrich
gini	gini
ginnasial	ginnasial
ginnasiali	ginnasial
ginnasio	ginnasio
ginnast	ginnast
ginnasta	ginnast
ginnasti	ginnast
ginnastica	ginnastic
ginnastich	ginnastic
ginni	ginni
ginnich	ginnic
ginnico	ginnic
gino	gino
ginocchia	ginocchi
ginocchio	ginocchi
ginsberg	ginsberg
ginsburg	ginsburg
ginseng	ginseng
ginvera	ginvera
ginverina	ginverina
ginwala	ginwala
ginza	ginza
gio	gio
gioacchino	gioacchino
gioachino	gioachino
gioanola	gioanola
gioar	gioar
gioberti	gioberti
gioca	gioca
giocando	giocando
giocano	giocano
giocar	gioca
giocarla	giocarla
giocarono	giocarono
giocarsi	giocarsi
giocass	giocass
giocat	giocat
giocata	giocat
giocati	giocat
giocato	giocat
giocatolo	giocatolo
giocator	giocator
giocatori	giocator
giocatric	giocatric
giocattoli	giocattol
giocattolo	giocattol
giocava	giocav
giocavano	giocavano
giocavo	giocav
giocheranno	giocheranno
giocherebb	giocherebb
giocherellava	giocherellava
giocherellon	giocherellon
giocherelloni	giocherellon
giocherà	giocherà
giochetti	giochett
giochetto	giochett
giochi	giochi
giochiamo	giochiamo
giochini	giochin
giochino	giochin
gioco	gioco
giocoforza	giocoforza
giocolier	giocolier
giocolieri	giocolier
gioconda	gioconda
giocoso	giocoso
giocò	giocò
giodato	giodato
gioeilli	gioeilli
gioelleria	gioelleria
giogo	giogo
giogoli	giogoli
giohar	giohar
gioia	gioia
gioie	gioie
gioiell	gioiell
gioieller	gioieller
gioielleri	gioielleri
gioielleria	gioielleri
gioielli	gioiell
gioiellier	gioiellier
gioielliera	gioiellier
gioiellieri	gioiellieri
gioiellieria	gioiellieri
gioiellino	gioiellino
gioiello	gioiell
gioillier	gioillier
gioios	gioios
gioiosa	gioios
gioiosament	gioiosament
gioioso	gioios
gioir	gioir
gioiscono	gioiscono
gioito	gioito
giokar	giokar
giokhar	giokhar
giokhr	giokhr
gioktar	gioktar
giolittiana	giolittiana
gion	gion
gional	gional
gionalisti	gionalisti
gionata	gionata
gionevra	gionevra
gioni	gioni
giono	giono
gionri	gionr
gionro	gionr
gionta	gionta
giopvedì	giopvedì
gioranlistica	gioranlistica
giorant	giorant
giordan	giordan
giordana	giordan
giordanello	giordanello
giordanetti	giordanetti
giordani	giordani
giordania	giordani
giordanià	giordani
giordano	giordan
giordio	giordio
giorgi	giorg
giorgia	giorgia
giorgian	giorgia
giorgianni	giorgianni
giorgieri	giorgieri
giorgini	giorgini
giorgio	giorgio
giorgion	giorgio
giorgo	giorg
giormo	giormo
giorn	giorn
giornaisti	giornaisti
giornal	giornal
giornalai	giornalai
giornalaio	giornalai
giornaletti	giornaletti
giornali	giornal
giornalier	giornalier
giornaliera	giornalier
giornalieri	giornalier
giornaliero	giornalier
giornalino	giornalino
giornalismo	giornalismo
giornalist	giornalist
giornalista	giornalist
giornalisti	giornalist
giornalistica	giornalistic
giornalistich	giornalistic
giornalistici	giornalistic
giornalistico	giornalistic
giornalisto	giornalist
giornalita	giornalita
giornalitich	giornalitich
giornalitsi	giornalitsi
giornallisti	giornallisti
giornalment	giornalment
giornalsita	giornalsita
giornalsti	giornalsti
giornalé	giornal
giornat	giornat
giornata	giornat
giorni	giorn
giornico	giornico
giornidi	giornidi
giornlaisti	giornlaisti
giornnalisti	giornnalisti
giorno	giorn
giornri	giornri
giornì	giorn
gioro	gioro
giorpi	giorpi
giorro	giorro
giosanna	giosanna
giostr	giostr
giostra	giostra
giostrai	giostra
giostri	giostr
giosuè	giosu
giosué	giosu
giotto	giotto
giouridici	giouridici
gioustizia	gioustizia
giov	giov
giova	giova
giovacchino	giovacchino
giovambattista	giovambattista
giovamento	giovamento
giovan	giovan
giovanardi	giovanardi
giovanbattista	giovanbattista
giovandosi	giovandosi
giovanett	giovanett
giovanetta	giovanett
giovanetti	giovanett
giovani	giovan
giovanil	giovanil
giovanili	giovanil
giovanissim	giovanissim
giovanissima	giovanissim
giovanissimi	giovanissim
giovanissimo	giovanissim
giovanissm	giovanissm
giovann	giovann
giovanna	giovann
giovannelli	giovannelli
giovanni	giovann
giovannini	giovannin
giovannino	giovannin
giovano	giovan
giovanotti	giovanotti
giovanottini	giovanottini
giovanotto	giovanotto
giovanotton	giovanotto
giovantù	giovantù
giovar	giovar
giovarl	giovar
giovarn	giovar
giovarsi	giovarsi
giovati	giovat
giovato	giovat
giovedi	gioved
giovedì	gioved
gioventu	giovent
gioventutà	gioventutà
gioventù	giovent
gioveranno	gioveranno
gioverdì	gioverdì
gioverebb	gioverebb
gioverà	gioverà
giovial	giovial
gioviana	gioviana
giovin	giovin
giovinastri	giovinastri
giovinetta	giovinetta
giovinezza	giovinezza
giovino	giovin
gioé	gioé
gip	gip
gipaeto	gipaeto
gipeti	gipet
gipeto	gipet
gipo	gipo
gippon	gippon
gipponi	gippon
giprospetsgaz	giprospetsgaz
gipsi	gipsi
gira	gira
giradino	giradino
giradot	giradot
giradoux	giradoux
giraff	giraff
giraffa	giraff
giraffino	giraffino
giraldo	giraldo
giramenti	giramenti
giramondo	giramondo
girando	girando
girandol	girandol
girandola	girandol
girandoli	girandol
girandolo	girandol
girano	girano
girar	girar
girard	girar
girardet	girardet
girardin	girardin
girargli	girargli
girarla	girarl
girarli	girarl
girarlo	girarl
girarono	girarono
girarsi	girarsi
girasol	girasol
girasoli	girasol
girass	girass
girat	girat
girata	girat
girati	girat
girato	girat
giraud	giraud
giraudi	giraud
girava	girav
giravano	giravano
giravo	girav
giravolta	giravolta
girello	girello
girerà	girer
girerò	girer
girevol	girevol
girgenti	girgenti
giri	giri
girija	girija
girijana	girijana
girish	girish
girk	girk
girl	girl
girnal	girnal
girnata	girnata
giro	giro
girod	girod
girodoux	girodoux
girola	girola
girolamo	girolamo
giroldi	giroldi
giron	giron
girond	girond
gironda	girond
gironi	giron
gironzola	gironzola
gironzolato	gironzolato
gironzolavamo	gironzolavamo
giroscopio	giroscopio
girotondo	girotondo
giroud	giroud
girovagato	girovagato
girovaghi	girovaghi
girovago	girovago
girozentral	girozentral
girt	girt
girò	girò
giscard	giscard
giscardiana	giscardian
giscardiani	giscardian
giscardiano	giscardian
gisel	gisel
gisela	gisel
giseni	giseni
gisenvi	gisenvi
giseny	giseny
gisenyi	giseny
gisenyl	giseny
gisgiordania	gisgiordania
gisgno	gisgno
gishwati	gishwati
gishyta	gishyta
gisi	gisi
gisig	gisig
gisikon	gisikon
gisil	gisil
gisladottir	gisladottir
gisler	gisler
gismattulin	gismattulin
gisotti	gisotti
gist	gist
gistizia	gistizia
gisutizia	gisutizia
giswil	giswil
git	git
gita	gita
gitai	gitai
gitamara	gitamara
gitan	gitan
gitana	gitan
gitani	gitan
gitanillo	gitanillo
gitano	gitan
gitanti	gitanti
gitarama	gitarama
gite	gite
gitega	gitega
gitjhar	gitjhar
gitlin	gitlin
gittat	gittat
gittata	gittat
gitten	gitten
gitwa	gitwa
giu	giu
giuba	giuba
giubb	giubb
giubbetti	giubbett
giubbetto	giubbett
giubbotti	giubbott
giubbotto	giubbott
giubiasco	giubiasco
giubilant	giubilant
giubilato	giubilato
giubilatoria	giubilatoria
giubilazion	giubilazion
giubileo	giubileo
giubilo	giubilo
giubotti	giubott
giubotto	giubott
giud	giud
giuda	giuda
giudaica	giudaic
giudaich	giudaic
giudaici	giudaic
giudaico	giudaic
giudaismo	giudaismo
giudaizzar	giudaizzar
giudaizzazion	giudaizzazion
giudati	giudati
giudea	giude
giudei	giude
giudeo	giude
giuderà	giuderà
giudiaria	giudiaria
giudic	giudic
giudica	giudica
giudicando	giudicando
giudicandol	giudicandol
giudicandola	giudicandol
giudicandoli	giudicandol
giudicandolo	giudicandol
giudicano	giudican
giudicant	giudican
giudicar	giudica
giudicarla	giudicarl
giudicarli	giudicarl
giudicarlo	giudicarl
giudicarono	giudicarono
giudicass	giudicass
giudicata	giudicat
giudicati	giudicat
giudicato	giudicat
giudicatric	giudicatric
giudicava	giudicava
giudicavano	giudicavano
giudiceandrea	giudiceandrea
giudiceistruttor	giudiceistruttor
giudicessa	giudicessa
giudich	giudich
giudicheranno	giudicheranno
giudicheremo	giudicheremo
giudicherà	giudicherà
giudichi	giudich
giudichiamo	giudichiamo
giudichino	giudichino
giudici	giudic
giudico	giudic
giudicò	giudic
giuditta	giuditta
giudizari	giudizari
giudizaria	giudizari
giudizi	giudizi
giudizial	giudizial
giudiziali	giudizial
giudizialment	giudizialment
giudiziar	giudiziar
giudiziara	giudiziar
giudiziari	giudiziari
giudiziaria	giudiziari
giudiziario	giudiziari
giudizii	giudizi
giudizio	giudizio
giudizion	giudizio
giudiziosa	giudizios
giudizioso	giudizios
giudiziria	giudiziria
giudizo	giudizo
giuffr	giuffr
giuffrida	giuffrida
giuffré	giuffr
giugendo	giugendo
giugerà	giugerà
giuggiol	giuggiol
giugiaro	giugiaro
giugliano	giugliano
giuglio	giuglio
giugner	giugner
giugni	giugn
giugno	giugn
giugular	giugular
giuistizia	giuistizia
giuizio	giuizio
giuletta	giuletta
giulia	giuli
giuliana	giulian
giuliani	giulian
giuliano	giulian
giulietta	giuliett
giulietti	giuliett
giulietto	giuliett
giulini	giulin
giulino	giulin
giulio	giuli
giullari	giullari
giumaglio	giumaglio
giunchi	giunchi
giunchiglia	giunchiglia
giunco	giunco
giung	giung
giunga	giung
giunganno	giunganno
giungano	giungano
giungendo	giungendo
giunger	giunger
giungera	giunger
giungeranno	giungeranno
giungerebb	giungerebb
giungerebbero	giungerebbero
giungeremo	giungeremo
giungern	giunger
giungervi	giungervi
giungerà	giunger
giungess	giungess
giungessero	giungessero
giungeva	giungeva
giungevano	giungevano
giungl	giungl
giungla	giungl
giungo	giung
giungono	giungono
giungonointanto	giungonointanto
giuns	giuns
giunsero	giunsero
giunt	giunt
giunta	giunta
giuntagli	giuntagli
giuntar	giunta
giuntegli	giuntegli
giunti	giunt
giuntivi	giuntivi
giunto	giunt
giuntur	giuntur
giuntura	giuntur
giuocar	giuocar
giuoco	giuoco
giura	giura
giurament	giurament
giuramenti	giurament
giuramento	giurament
giurammo	giurammo
giurando	giurando
giurandosi	giurandosi
giurano	giurano
giurar	giura
giurassian	giurassian
giurassiana	giurassian
giurassiani	giurassian
giurassiano	giurassian
giurassico	giurassico
giurat	giurat
giurata	giurat
giurati	giurat
giurato	giurat
giurava	giurava
giurazza	giurazza
giurerebb	giurerebb
giurerà	giurer
giurerò	giurer
giuri	giuri
giuria	giuri
giuridament	giuridament
giuridica	giuridic
giuridicament	giuridicament
giuridich	giuridich
giuridiché	giuridich
giuridici	giuridic
giuridico	giuridic
giuridiziaria	giuridiziaria
giuridizion	giuridizion
giuridizionali	giuridizionali
giurino	giurino
giurisdizion	giurisdizion
giurisdizional	giurisdizional
giurisdizionali	giurisdizional
giurisdizioni	giurisdizion
giurisprodenza	giurisprodenza
giurispruden	giurispruden
giurisprudenza	giurisprudenza
giurisprudenziali	giurisprudenziali
giurista	giurist
giuristi	giurist
giuro	giuro
giursanniani	giursanniani
giurì	giurì
giurò	giurò
gius	gius
giusep	giusep
giusepp	giusepp
giuseppa	giusepp
giuseppina	giuseppina
giusi	giusi
giusitif	giusitif
giusitizia	giusitizia
giusitzia	giusitzia
giusizia	giusizia
giussano	giussano
giust	giust
giusta	giust
giustament	giustament
giustapposto	giustapposto
giustezza	giustezza
giusti	giusti
giusticano	giusticano
giusticar	giusticar
giustif	giusti
giustifica	giustific
giustificabil	giustificabil
giustificabili	giustificabil
giustificando	giustificando
giustificandoli	giustificandol
giustificandolo	giustificandol
giustificandosi	giustificandosi
giustificano	giustificano
giustificanti	giustificanti
giustificar	giustificar
giustificarla	giustificarl
giustificarli	giustificarl
giustificarn	giustificar
giustificarsi	giustificarsi
giustificass	giustificass
giustificata	giustificat
giustificati	giustificat
giustificato	giustificat
giustificatric	giustificatric
giustificava	giustificava
giustificavano	giustificavano
giustificazion	giustificazion
giustificazioni	giustificazion
giustificherebb	giustificherebb
giustificherebbero	giustificherebbero
giustificherà	giustificherà
giustifichi	giustifichi
giustifichino	giustifichino
giustificiabili	giustificiabili
giustificò	giustific
giustiniani	giustiniani
giustino	giustino
giustiza	giustiz
giustizi	giustiz
giustizia	giustizia
giustizialista	giustizialist
giustizialisti	giustizialist
giustiziando	giustiziando
giustiziar	giustizia
giustiziarlo	giustiziarlo
giustiziass	giustiziass
giustiziata	giustiziat
giustiziati	giustiziat
giustiziato	giustiziat
giustiziatò	giustiziat
giustizier	giustizier
giustizieri	giustizier
giustizio	giustizio
giustizioa	giustizio
giusto	giust
giustì	giust
giustò	giust
giutizia	giutizia
giutno	giutno
giuventù	giuventù
giuvna	giuvna
givan	givan
givanni	givanni
givat	givat
givataym	givataym
givaudan	givaudan
givedì	givedì
givel	givel
given	given
givisi	givisi
givisiez	givisiez
givoedì	givoedì
giza	giza
gizenyi	gizenyi
già	già
giàin	giàin
giò	giò
giù	giù
gjergj	gjergj
gjin	gjin
gjini	gjini
gjinushi	gjinushi
gjiokhar	gjiokhar
gjirokast	gjirokast
gk	gk
gkn	gkn
gl	gl
glabro	glabro
glacial	glacial
glaciali	glacial
glaciazion	glaciazion
glaciazioni	glaciazion
glacier	glacier
glaciologia	glaciologia
glaciologico	glaciologico
glad	glad
gladbach	gladbach
gladbeck	gladbeck
gladiator	gladiator
gladiatori	gladiatori
gladiatorio	gladiatori
gladio	gladio
gladkov	gladkov
glafco	glafco
glafko	glafko
glam	glam
glamoc	glamoc
glamorosa	glamorosa
glamour	glamour
gland	gland
glandolari	glandolari
glane	glane
glanzfest	glanzfest
glari	glari
glarner	glarner
glarona	glarona
glarones	glarones
glaronesi	glarones
glaru	glaru
glasco	glasco
glaser	glaser
glasgow	glasgow
glaskow	glaskow
glasnost	glasnost
glasov	glasov
glass	glass
glassa	glassa
glassat	glassa
glassboro	glassboro
glasser	glasser
glattbrug	glattbrug
glattbrugg	glattbrug
glattfelden	glattfelden
glaubengerg	glaubengerg
glauco	glauc
glaucoma	glaucoma
glaucu	glauc
glauser	glauser
glava	glava
glavani	glavani
glavnai	glavnai
glavon	glavon
glaxo	glaxo
glazer	glazer
glaziev	glaziev
gleacher	gleacher
gleason	gleason
gleb	gleb
gleghorn	gleghorn
gleichmann	gleichmann
gleinalm	gleinalm
gleizer	gleizer
glemp	glemp
glen	glen
glencor	glencor
glenda	glenda
glendal	glenda
glenden	glenden
glengarri	glengarri
gleni	gleni
glenn	glenn
glenna	glenn
glenrowan	glenrowan
glenwood	glenwood
gleyr	gleyr
glf	glf
glia	glia
gliassassini	gliassassini
gliattacchi	gliattacchi
glicerin	glicerin
glicerina	glicerin
glicini	glicini
glick	glick
glickman	glickman
glicol	glicol
glie	glie
glieckfield	glieckfield
gliel	gliel
gliela	gliel
glieli	gliel
glielo	gliel
glien	glien
glienick	glienick
glienka	glienka
glifada	glifada
gligorov	gligorov
gligsburg	gligsburg
glikorov	glikorov
glilon	glilon
glina	glina
glinka	glinka
gliotton	gliotton
glisenti	glisenti
gliss	gliss
glissar	glissar
glo	glo
globa	globa
global	global
globalemnt	globalemnt
globali	global
globalità	globalità
globalizzazion	globalizzazion
globalment	globalment
globe	globe
globesat	globesat
globi	globi
globmail	globmail
globo	globo
globu	globu
globudata	globudata
globular	globular
globuli	globuli
glocest	glocest
glodz	glodz
gloed	gloed
gloor	gloor
glori	glori
gloria	glori
gloriarsi	gloriarsi
glorificano	glorificano
glorificar	glorificar
glorificato	glorificato
glorios	glorios
gloriosa	glorios
gloriosament	gloriosament
gloriosi	glorios
glorioso	glorios
glossair	glossair
glostrup	glostrup
gloucest	gloucest
gloucestershir	gloucestershir
glouscest	glouscest
glova	glova
gloveli	gloveli
glover	glover
glovier	glovier
glr	glr
glsa	glsa
glucidi	glucidi
glucksman	glucksman
glucksmann	glucksman
glucosio	glucosio
gluecher	gluecher
gluehwein	gluehwein
gluska	gluska
glutei	glute
gluteo	glute
glutz	glutz
glycosid	glycosid
glykatzi	glykatzi
glyn	glyn
glyndebourn	glyndebourn
glyndr	glyndr
glâne	glâne
glìscandalì	glìscandalì
glückspost	glückspost
glücksrevu	glücksrevu
gm	gm
gmb	gmb
gmbh	gmbh
gmc	gmc
gmelin	gmelin
gmt	gmt
gmtv	gmtv
gmünden	gmünden
gmür	gmür
gnassingb	gnassingb
gnassingbé	gnassingb
gnat	gnat
gnc	gnc
gneiss	gneiss
gneosologica	gneosologica
gneral	gneral
gniczno	gniczno
gniezno	gniezno
gnininvi	gnininvi
gnomi	gnomi
gnomo	gnomo
gnosca	gnosca
gnossighé	gnossighé
gnozzi	gnozzi
gnrh	gnrh
gnutti	gnutti
gnw	gnw
gnädiger	gnädiger
gnädinger	gnädinger
gnägi	gnägi
go	go
goa	goa
goal	goal
goat	goat
gobadi	gobadi
gobain	gobain
gobba	gobba
gobbo	gobbo
gobelin	gobelin
gobernador	gobernador
gobert	gobert
gobet	gobet
gobetti	gobetti
gobi	gobi
gobilliard	gobilliard
gocc	gocc
goccetto	goccetto
goccia	goccia
gocciola	gocciola
gocciolar	gocciola
gocciolin	gocciolin
goclowski	goclowski
gocott	gocott
god	god
goda	goda
godal	godal
godano	godano
godard	godard
goddard	goddard
gode	gode
godena	godena
godendo	godendo
godendosi	godendosi
goder	goder
godercela	godercela
goderci	goderci
godereccia	godereccia
goderl	goder
godern	goder
godersela	godersela
godersi	godersi
godesberg	godesberg
godess	godess
godessimo	godessimo
godet	godet
godeva	godeva
godevano	godevano
godfrei	godfrei
godfri	godfri
godfroid	godfroid
godi	godi
godiamo	godiamo
godibil	godibil
godibilissmi	godibilissmi
godimento	godimento
godinez	godinez
godlevaska	godlevaska
godo	godo
godono	godono
godot	godot
godranno	godranno
godrano	godrano
godrebb	godrebb
godrebbero	godrebbero
godrà	godrà
godunov	godunov
godut	godut
goduta	godut
goduti	godut
goduto	godut
godwin	godwin
godwyil	godwyil
godzi	godzi
goe	goe
goea	goea
goebbel	goebbel
goebel	goebel
goencz	goencz
goenz	goenz
goepfritz	goepfritz
goeppingen	goeppingen
goer	goer
goeran	goeran
goerel	goerel
goerg	goerg
goergi	goerg
goerlitz	goerlitz
goert	goert
goestl	goestl
goeteborg	goeteborg
goetghebu	goetghebu
goeth	goeth
goetschel	goetschel
goettel	goettel
goettingen	goettingen
goetz	goetz
goetzenhain	goetzenhain
goff	goff
goffa	goffa
goffaggin	goffaggin
goffo	goffo
goffredo	goffredo
gogh	gogh
gogic	gogic
goglio	goglio
gogna	gogna
gogol	gogol
gogrial	gogrial
goh	goh
gohari	gohari
goia	goia
goijko	goijko
goikhar	goikhar
goin	goin
goiricelaia	goiricelaia
goiti	goiti
goizueta	goizueta
gojko	gojko
gokcek	gokcek
goketidz	goketidz
goksel	goksel
gol	gol
gola	gola
golai	golai
golam	golam
golan	golan
golani	golan
golaz	golaz
golcuk	golcuk
gold	gold
golda	golda
goldach	goldach
goldau	golda
goldberg	goldberg
goldchläger	goldchläger
goldei	golde
goldemberg	goldemberg
golden	golde
goldenberg	goldenberg
goldeney	goldeney
goldenson	goldenson
goldenstrass	goldenstrass
goldestein	goldestein
goldeston	goldeston
goldfarb	goldfarb
goldfing	goldfing
goldifield	goldifield
goldin	goldin
goldlo	goldlo
goldman	goldman
goldmann	goldman
goldoni	goldoni
goldoniana	goldoniana
goldsboro	goldsboro
goldschmid	goldschmid
goldsmith	goldsmith
goldstar	goldstar
goldstein	goldstein
goldston	goldston
goldswil	goldswil
goldtsein	goldtsein
goldtson	goldtson
goldwat	goldwat
goldwin	goldwin
goldwyn	goldwyn
gole	gole
golem	golem
golenali	golenali
goletta	goletta
golf	golf
golfari	golfari
golfing	golfin
golfino	golfin
golfo	golfo
golgo	golgo
golgota	golgota
golhan	golhan
goli	goli
golia	golia
goliardi	goliardi
goliardia	goliardi
goliardica	goliardic
goliardico	goliardic
golienkin	golienkin
golikov	golikov
goljia	goljia
goll	goll
golli	golli
gollista	gollist
gollisti	gollist
gollistica	gollistica
golmohama	golmohama
golo	golo
golodkowski	golodkowski
golosament	golosament
golosi	golosi
golosità	golosità
golp	golp
golpista	golpist
golpisti	golpist
golsk	golsk
golstein	golstein
goltz	goltz
golub	golub
golubcov	golubcov
golubkov	golubkov
golubo	golubo
golubov	golubo
golubovici	golubovici
golushko	golushko
gom	gom
goma	goma
gomaa	gomaa
gomaer	gomaer
gomb	gomb
gombojav	gombojav
gome	gome
gomea	gomea
gomel	gomel
gomez	gomez
gomhouria	gomhouria
gomhureya	gomhureya
gomhuria	gomhuria
gomila	gomila
gomiti	gomit
gomito	gomit
gomm	gomm
gomma	gomma
gommon	gommon
gommoni	gommon
gomora	gomora
gomurehya	gomurehya
gona	gona
gonadi	gonadi
gonadotropin	gonadotropin
gonadotropina	gonadotropin
gonaiv	gonaiv
gonazlez	gonazlez
goncalv	goncalv
goncarov	goncarov
gonciar	gonciar
gonciarov	gonciarov
goncourt	goncourt
goncz	goncz
gond	gond
gonda	gonda
gondim	gondim
gondo	gondo
gondol	gondol
gondola	gondol
gondreé	gondreé
gonella	gonella
gonen	gonen
goness	goness
gonfalon	gonfalon
gonfaloni	gonfalon
gonfi	gonfi
gonfia	gonfia
gonfiabil	gonfiabil
gonfiabili	gonfiabil
gonfiando	gonfiando
gonfiandolo	gonfiandolo
gonfiar	gonfia
gonfiarsi	gonfiarsi
gonfiass	gonfiass
gonfiat	gonfiat
gonfiata	gonfiat
gonfiati	gonfiat
gonfiato	gonfiat
gonfiava	gonfiava
gonfio	gonfi
gonfior	gonfior
gonfiori	gonfior
gong	gong
gongh	gongh
gongola	gongola
gongolant	gongolant
gongolar	gongola
gonja	gonja
gonn	gonn
gonna	gonna
gonnella	gonnella
gonnellina	gonnellin
gonnellini	gonnellin
gonnellino	gonnellin
gonon	gonon
gonorrea	gonorrea
gonsalv	gonsalv
gonseth	gonseth
gontern	gontern
gonzaga	gonzaga
gonzal	gonzal
gonzalez	gonzalez
gonzalo	gonzal
good	good
gooda	gooda
goodal	gooda
goodhart	goodhart
goodman	goodman
goodrich	goodrich
goodwil	goodwi
goodwin	goodwi
goodyear	goodyear
goon	goon
gooren	gooren
goorjian	goorjian
goos	goos
gop	gop
gopinath	gopinath
goplana	goplana
goppel	goppel
goppenstein	goppenstein
goppion	goppion
gopstein	gopstein
gor	gor
gora	gora
goradiz	goradiz
goradz	goradz
goral	goral
goran	goran
gorani	goran
goraz	goraz
gorazd	gorazd
gorazdé	gorazd
gorbaciov	gorbaciov
gorbacioviana	gorbacioviana
gorbatko	gorbatko
gorchinski	gorchinski
gorchkhanov	gorchkhanov
gorcu	gorcu
gord	gord
gordana	gordana
gordevio	gordevio
gordiano	gordiano
gordieev	gordieev
gordievski	gordievski
gordievskij	gordievski
gordim	gordim
gordola	gordola
gordon	gordon
gordona	gordon
gordonstoun	gordonstoun
gordò	gordò
gore	gore
gorelick	gorelick
goren	goren
goretta	gorett
goretti	gorett
gorezmetteln	gorezmetteln
gorga	gorga
gorgab	gorga
gorgan	gorga
gorgier	gorgier
gorgo	gorgo
gorgoglianti	gorgoglianti
gori	gori
goria	goria
goriaciov	goriaciov
gorilla	gorilla
gorizia	gorizia
gorj	gorj
gorjevac	gorjevac
gorji	gorji
gorki	gorki
gorleben	gorleben
gorman	gorman
gornalisti	gornalisti
gorni	gorni
gornij	gorni
gornj	gornj
gornji	gornj
gorno	gorno
goro	goro
goron	goron
gorotir	gorotir
gorrieri	gorrieri
gorshenin	gorshenin
gorshkov	gorshkov
gorsokova	gorsokova
gortari	gortari
gorzini	gorzini
gosainthan	gosainthan
gosatomnadzor	gosatomnadzor
gosbank	gosbank
goscinni	goscinni
gosco	gosco
gosden	gosden
gosetti	gosetti
gosford	gosford
gosheh	gosheh
goskomoboronprom	goskomoboronprom
goslar	goslar
gospel	gospe
gosper	gospe
gospic	gospic
gospijina	gospijina
gosplan	gosplan
gospodin	gospodin
gossau	gossau
gossin	gossin
gostevc	gostevc
goteborg	goteborg
gotemba	gotemba
goth	goth
gotha	gotha
goti	goti
gotica	gotic
gotich	gotic
goticheggiant	goticheggiant
gotici	gotic
gotico	gotic
goto	goto
gott	gott
gottardi	gottard
gottardisti	gottardisti
gottardo	gottard
gotteron	gotteron
gottfri	gottfri
gotthard	gotthard
gotthelf	gotthelf
gotti	gotti
gottinga	gottinga
gottleib	gottleib
gottlieb	gottlieb
gotto	gotto
gottschol	gottschol
gottwald	gottwald
gotyla	gotyla
gou	gou
goudoev	goudoev
gouellain	gouellain
gough	gough
goujon	goujon
goulandri	goulandri
gould	gould
gounod	gounod
goupi	goupi
goupil	goupi
gourat	gourat
gourault	gourault
gourgon	gourgon
gourion	gourion
gourmelon	gourmelon
gourmet	gourmet
gourraud	gourraud
goush	goush
gousmi	gousmi
goussainvil	goussainvil
gouter	gouter
gouveia	gouveia
gouvela	gouvela
gouz	gouz
govahi	govahi
govan	govan
govani	govan
goveani	goveani
goven	goven
govenativa	govenativa
govenator	govenator
goveno	goven
govenro	govenro
goveranitiva	goveranitiva
goverantiva	goverantiv
goverantivo	goverantiv
goverativa	goverativa
goveratorato	goveratorato
govern	govern
governa	governa
governabil	governabil
governabilità	governabilità
governamental	governamental
governano	governano
governant	governant
governanti	governant
governar	governa
governarci	governarci
governarono	governarono
governata	governat
governati	governat
governativ	governativ
governativa	governativ
governativi	governativ
governativo	governativ
governativò	governativ
governato	governat
governator	governator
governatorati	governatorat
governatorato	governatorat
governatori	governator
governatorial	governatorial
governatoriali	governatorial
governatric	governatric
governava	governava
governavano	governavano
governerà	governerà
governi	govern
governino	governino
governitiva	governitiva
governno	governno
governo	governo
governonon	governonon
governor	governo
governò	govern
govero	govero
govind	govind
govindsi	govindsi
govrern	govrern
govrin	govrin
govverno	govverno
gowan	gowan
gowari	gowari
gower	gower
goya	goya
goyan	goyan
goymen	goymen
gozaresh	gozaresh
gozzetti	gozzetti
gozzo	gozzo
gp	gp
gp11	gp11
gpa	gpa
gpc	gpc
gpe	gpe
gpl	gpl
gpu	gpu
gpv	gpv
gqozo	gqozo
gqumfa	gqumfa
gr	gr
gr1	gr1
gr2	gr2
gra	gra
graad	graad
graaf	graaf
graaff	graaf
graal	graal
grab	grab
graben	grabe
graber	grabe
grabez	grabe
grabovica	grabovica
grabow	grabow
graca	graca
gracanica	gracanica
gracchiant	gracchiant
gracchiar	gracchiar
grace	grace
graceland	graceland
grach	grach
graci	graci
gracia	graci
gracidar	gracidar
graciela	graciela
gracil	gracil
gracili	gracil
graciliano	graciliano
graciov	graciov
grad	grad
gradacac	gradacac
gradando	gradando
gradatament	gradatament
gradazion	gradazion
gradazioni	gradazion
grade	grade
gradevol	gradevol
gradevoli	gradevol
gradi	gradi
gradimenti	gradiment
gradimento	gradiment
gradin	gradin
gradina	gradin
gradini	gradin
gradino	gradin
gradir	gradir
gradiranno	gradiranno
gradirebb	gradirebb
gradiremmo	gradiremmo
gradirà	gradir
gradisc	gradisc
gradisca	gradisc
gradisch	gradisc
gradish	gradis
gradiska	gradiska
gradiss	gradis
gradit	gradit
gradita	gradit
graditi	gradit
gradito	gradit
gradivano	gradivano
grado	grado
gradodi	gradodi
gradson	gradson
gradual	gradual
graduali	gradual
gradualismi	gradualism
gradualismo	gradualism
gradualita	gradualit
gradualità	gradualit
gradualment	gradualment
gradualmenté	gradualment
graduati	graduat
graduato	graduat
graduatori	graduatori
graduatoria	graduatori
gradutoria	gradutoria
graebner	graebner
graem	graem
graevenbeck	graevenbeck
graf	graf
graff	graff
graffenri	graffenri
graffi	graffi
graffiant	graffiant
graffiat	graffiat
graffiati	graffiat
graffiato	graffiat
graffio	graffi
graffit	graffit
graffiti	graffit
graffito	graffit
graffitti	graffitti
grafi	grafi
grafia	grafi
grafica	grafic
graficament	graficament
grafich	grafic
grafici	grafic
grafico	grafic
grafigo	grafigo
grafin	grafi
grafiscrit	grafiscrit
grafismo	grafismo
grafit	grafi
grafolog	grafolog
grafologia	grafologia
grafologo	grafolog
grafoman	grafoman
grafton	grafton
gragnaniello	gragnaniello
gragnuola	gragnuola
graham	graha
grahan	graha
grahovo	grahovo
grai	grai
graig	graig
graignac	graignac
graignic	graignic
graijevski	graijevski
grain	grain
grajal	grajal
gram	gram
grama	grama
gramagli	gramagli
gramaglia	gramagli
graman	grama
grami	grami
gramigna	gramigna
gramlich	gramlich
gramm	gramm
grammatica	grammatica
grammatical	grammatical
grammaticali	grammatical
grammi	gramm
grammo	gramm
grammofono	grammofono
gramsci	gramsci
gran	gran
grana	grana
granada	granad
granado	granad
granagli	granagli
granai	granai
granaio	granai
granara	granara
granat	granat
granata	granat
granatieri	granatieri
grancagnolo	grancagnolo
grancassa	grancassa
granchi	granchi
granchio	granchi
granché	granché
granconsiglier	granconsiglier
granconsigliera	granconsiglier
granconsiglieri	granconsiglier
granconsiglio	granconsiglio
grand	grand
grandat	grandat
grandement	grandement
granderson	granderson
grandeur	grandeur
grandezz	grandezz
grandezza	grandezz
grandguignoleschi	grandguignoleschi
grandi	grand
grandicella	grandicell
grandicelli	grandicell
grandin	grandin
grandinato	grandinato
grandini	grandin
grandios	grandios
grandiosa	grandios
grandiosi	grandios
grandiosità	grandiosità
grandioso	grandios
grandissim	grandissim
grandissima	grandissim
grandissimi	grandissim
grandissimo	grandissim
grandissma	grandissma
grandjacquet	grandjacquet
grandjean	grandjean
grando	grand
grandola	grandola
grandson	grandson
granduca	granduca
granducal	granduca
granducato	granducato
granduchessa	granduchessa
grandval	grandval
grandvilar	grandvilar
grandvillard	grandvillard
grane	grane
granedin	granedin
granelli	granell
granello	granell
grang	grang
grangeneuv	grangeneuv
granger	granger
grangier	grangier
grani	grani
granic	grani
granier	granier
granini	granini
graniti	granit
granitica	granitic
granitico	granitic
granito	granit
granjon	granjon
grankuwa	grankuwa
granma	granma
grano	grano
grant	grant
grantham	grantham
grantir	grantir
granturco	granturco
granulati	granulati
granval	granval
granvil	granvil
granzotto	granzotto
granzow	granzow
grape	grape
grapevin	grapevin
grapo	grapo
grapolo	grapolo
grapp	grapp
grappa	grapp
grappoli	grappol
grappolo	grappol
graranzi	graranzi
grasi	grasi
grass	grass
grassa	grass
grassatori	grassatori
grassazion	grassazion
grasset	grasset
grassetto	grassetto
grassezza	grassezza
grasshopp	grasshopp
grassi	grass
grassissimi	grassissimi
grasslei	grasslei
grasso	grasso
grassoccia	grassoccia
grasson	grasso
grassonelli	grassonelli
grasswil	grasswil
grastronomica	grastronomica
grata	grata
gratchev	gratchev
grate	grate
grati	grati
graticola	graticola
gratidudin	gratidudin
gratifica	gratifica
gratificant	gratificant
gratificanti	gratificant
gratificar	gratifica
gratificarsi	gratificarsi
gratificato	gratificat
gratificatò	gratificat
gratificavano	gratificavano
gratificazion	gratificazion
gratificazioni	gratificazion
gratifich	gratifich
gratitudin	gratitudin
grato	grato
gratsi	gratsi
gratta	gratta
grattac	grattac
grattacapi	grattacap
grattacapo	grattacap
grattaci	grattac
grattacielo	grattacielo
grattacielodov	grattacielodov
grattando	grattando
grattar	gratta
grattarsi	grattarsi
gratton	gratton
gratuatoria	gratuatoria
gratuit	gratuit
gratuita	gratuit
gratuitament	gratuitament
gratuiti	gratuit
gratuito	gratuit
gratuità	gratuit
gratuuitament	gratuuitament
gratz	gratz
grau	grau
graubünden	graubünden
grauholz	grauholz
grauso	grauso
grava	grava
gravaa	grava
gravament	gravament
gravami	gravami
gravando	gravando
gravano	gravano
gravant	gravant
gravanti	gravant
gravar	grava
gravat	gravat
gravata	gravat
gravato	gravat
gravava	gravava
gravavano	gravavano
grave	grave
gravemebnt	gravemebnt
gravemenet	gravemenet
gravement	gravement
gravemet	gravemet
graveranno	graveranno
graverebb	graverebb
graverebbero	graverebbero
graverà	graverà
gravesano	gravesano
gravesend	gravesend
gravetumor	gravetumor
gravi	gravi
graviano	graviano
gravic	gravi
gravid	gravid
gravida	gravid
gravidanz	gravidanz
gravidanza	gravidanz
gravidi	gravid
gravika	gravika
gravina	gravin
gravino	gravin
gravisim	gravisim
gravissim	gravissim
gravissima	gravissim
gravissimi	gravissim
gravissimiproblemi	gravissimiproblemi
gravissimo	gravissim
gravissimì	gravissim
gravita	gravita
gravitano	gravitano
gravitar	gravita
gravitass	gravitass
gravitava	gravitava
gravitazion	gravitazion
gravitazional	gravitazional
graviterà	graviterà
gravità	gravità
gravon	gravon
gravosa	gravos
gravosi	gravos
gravoso	gravos
gravur	gravur
graw	graw
graybil	graybil
grayson	grayson
graz	graz
grazi	grazi
grazia	grazia
graziani	grazian
graziano	grazian
graziar	grazia
graziarli	graziarli
graziata	graziat
graziati	graziat
graziato	graziat
graziaö	grazia
graziella	graziella
graziosa	grazios
graziosi	grazios
grazioso	grazios
graziò	grazi
grazyna	grazyna
grbanica	grbanica
grbavica	grbavica
grbravica	grbravica
grdzelishvili	grdzelishvili
gre	gre
greas	greas
greaser	greaser
great	great
greatwal	greatwal
greav	greav
greca	greca
grech	grech
grechniev	grechniev
greci	greci
grecia	greci
grecista	grecista
grecità	grecità
greco	greco
gree	gree
greech	greech
greeenpeac	greeenpeac
greelaw	greelaw
green	green
greenawai	greenawai
greenbelt	greenbelt
greenberg	greenberg
greenburi	greenburi
greenfeld	greenfeld
greenfield	greenfield
greenhil	greenhil
greenpac	greenpac
greenpastur	greenpastur
greenpeac	greenpeac
greenpec	greenpec
greensboro	greensboro
greensburi	greensburi
greenspan	greenspan
greenspeac	greenspeac
greenster	greenster
greensvil	greensvil
greenvil	greenvil
greenwai	greenwai
greenwel	greenwel
greenwich	greenwich
greepeac	greepeac
greer	greer
greespan	greespan
greet	greet
greffier	greffier
greg	greg
greganti	greganti
gregario	gregario
gregg	gregg
greggi	greggi
greggio	greggi
gregoir	gregoir
gregor	gregor
gregori	gregori
gregoria	gregori
gregoriana	gregorian
gregoriani	gregorian
gregoriano	gregorian
gregorio	gregori
gregoroviu	gregoroviu
grei	grei
greifense	greifense
greiff	greiff
greifswald	greifswald
greinach	greinach
greindl	greindl
greiter	greiter
grell	grell
grellingen	grellingen
grembiulini	grembiulin
grembiulino	grembiulin
grembo	grembo
gremingen	gremingen
gremiscono	gremiscono
gremit	gremit
gremita	gremit
gremiti	gremit
gremitissimo	gremitissimo
gremito	gremit
gremivano	gremivano
grena	grena
grenaa	grena
grenach	grenach
grenada	grenada
grenadin	grenadin
grenberg	grenberg
grenchen	grenchen
grenchenberg	grenchenberg
grendelmei	grendelmei
grenel	grenel
grenfel	grenfel
grenier	grenier
grenil	grenil
grennpeac	grennpeac
grenobl	grenobl
grenzach	grenzach
grenzer	grenzer
grenztruppen	grenztruppen
gresham	gresham
gress	gress
gresser	gresser
gressler	gressler
gresznaryk	gresznaryk
gret	gret
greta	greta
gretario	gretario
grete	grete
greth	greth
grether	grether
greto	greto
gretta	grett
gretti	grett
gretto	grett
gretzenbach	gretzenbach
greuter	greuter
greve	greve
grevement	grevement
greyhound	greyhound
greysteel	greysteel
greyton	greyton
greytown	greytown
grezz	grezz
grezza	grezz
grezzi	grezz
grezzo	grezz
grgioni	grgioni
gri	gri
grib	grib
gricha	gricha
griciu	griciu
grid	grid
grida	grida
gridando	gridando
gridandogli	gridandogli
gridandol	gridando
gridano	gridano
gridar	grida
gridarlo	gridarlo
gridarono	gridarono
gridata	gridat
gridati	gridat
gridato	gridat
gridava	gridava
gridavano	gridavano
griderà	griderà
gridi	gridi
grido	grido
gridolini	gridolini
gridò	gridò
griechniev	griechniev
grieco	grieco
grieder	grieder
griefahn	griefahn
grieff	grieff
griev	griev
griff	griff
griffault	griffault
griffi	griffi
griffin	griffi
griffith	griffith
grifon	grifon
grige	grige
grigg	grigg
grighisk	grighisk
grigi	grigi
grigia	grigi
grigio	grigio
grigion	grigion
grigiones	grigiones
grigionesi	grigiones
grigioni	grigion
grigior	grigio
grigioverd	grigioverd
grigli	grigli
griglia	grigli
grigliata	grigliat
grigliato	grigliat
grignard	grignard
grigo	grigo
grigones	grigones
grigori	grigori
grigorian	grigorian
grigorov	grigorov
grill	grill
grillaki	grillaki
grillet	grillet
grilletto	grilletto
grilli	grill
grillmeier	grillmeier
grillo	grill
grilo	grilo
grim	grim
grimaldello	grimaldello
grimaldi	grimaldi
grimaud	grimaud
grime	grime
grimesel	grimesel
grimm	grimm
grimma	grimm
grimmelshofen	grimmelshofen
grimoldi	grimoldi
grimsel	grimsel
grinan	grinan
grinberg	grinberg
grindelwald	grindelwald
grindenwald	grindenwald
grine	grine
grinfi	grinfi
gringo	gringo
grinta	grinta
grintos	grintos
grintosa	grintos
grintosi	grintos
grintoso	grintos
grinveskij	grinveskij
grinyov	grinyov
grinzosa	grinzosa
grionalisti	grionalisti
gripp	gripp
grisaglia	grisaglia
grisaldi	grisaldi
grisar	grisar
grisard	grisar
grisch	grisch
grischa	grisch
grischun	grischun
grischuna	grischun
griscom	griscom
grisel	grisel
grisham	grisham
grishin	grishin
grisini	grisini
grison	griso
grisou	griso
grissom	grissom
grist	grist
gristina	gristina
grisù	grisù
gritti	gritti
gritz	gritz
griuppo	griuppo
griva	griva
grivitza	grivitza
grivna	grivna
grizunov	grizunov
grizzardi	grizzardi
grmec	grmec
grnade	grnade
gro	gro
grob	grob
grobet	grobet
grobéti	grobéti
grock	grock
grodstein	grodstein
grodzki	grodzki
groen	groen
groenland	groenland
groenlandesi	groenlandesi
groenlandia	groenlandia
groenwald	groenwald
grographo	grographo
grollei	grollei
gromoslaw	gromoslaw
gromov	gromov
gromyko	gromyko
gronchi	gronchi
grond	grond
gronda	grond
grondai	grondai
grondaia	grondai
grondano	grondano
grondant	grondant
grondanti	grondant
grondona	grondona
groner	groner
groningen	groningen
gronkiewicz	gronkiewicz
grono	grono
gronzi	gronzi
groosbard	groosbard
gropiu	gropiu
groppa	gropp
groppi	gropp
groppo	groppo
groppon	groppo
grosbéti	grosbéti
grosjean	grosjean
grosni	grosni
gross	gross
grossa	gross
grossaipar	grossaipar
grossbard	grossbard
grosschoenau	grosschoenau
grossdietwil	grossdietwil
grossen	grosse
grossenbach	grossenbach
grosser	grosse
grosseto	grosseto
grossgassenzimm	grossgassenzimm
grossi	gross
grossissim	grossissim
grossista	grossist
grossisti	grossist
grossman	grossman
grossmann	grossman
grosso	gross
grossolan	grossolan
grossolana	grossolan
grossolanament	grossolanament
grossolani	grossolan
grossolano	grossolan
grossomodo	grossomodo
grossouvr	grossouvr
grosvenor	grosvenor
grosz	grosz
grotfreund	grotfreund
groth	groth
grott	grott
grotta	grott
grottammar	grottammar
grotteco	grotteco
grottesca	grottesc
grottescament	grottescament
grottesch	grottesch
grotteschi	grottesch
grottesco	grottesc
grotti	grott
grotto	grott
grottta	grottta
grouchi	grouchi
groue	groue
ground	ground
group	group
groupement	groupement
grove	grove
grover	grove
groviera	groviera
grovigli	grovigli
groviglio	grovigli
growth	growth
groz	groz
groza	groza
grozhni	grozhni
grozni	grozni
grozzana	grozzana
grr	grr
grreg	grreg
grrossi	grrossi
grtafico	grtafico
gru	gru
grub	grub
grubber	grubber
gruber	gruber
gruchet	gruchet
grucho	grucho
grudet	grudet
grudnov	grudnov
gruenau	gruenau
gruenberg	gruenberg
gruenenth	gruenenth
gruga	gruga
grugliasco	grugliasco
gruista	gruista
grumi	grumi
grumman	grumman
grumo	grumo
grumpi	grumpi
grund	grund
grundtvig	grundtvig
grundwald	grundwald
grung	grung
grunwald	grunwald
grup	grup
grupo	grupo
grupp	grupp
gruppetti	gruppett
gruppetto	gruppett
gruppi	grupp
gruppo	gruppo
gruppoappartenent	gruppoappartenent
gruppon	gruppo
grupposcolo	grupposcolo
grupppo	grupppo
gruppuscoli	gruppuscol
gruppuscolo	gruppuscol
gruyer	gruyer
gruyèr	gruyèr
gruzzoletto	gruzzoletto
gruzzolo	gruzzolo
gryfic	gryfic
gryke	gryke
gryllaki	gryllaki
gryzbeck	gryzbeck
grzegorz	grzegorz
grzie	grzie
grächen	grächen
grädel	grädel
grätz	grätz
grätzer	grätzer
grèle	grèle
grégoir	grégoir
grüne	grüne
grünigen	grünige
grüniger	grünige
grüninger	grüninger
grütli	grütli
grütter	grütter
grützner	grützner
grüzenstrass	grüzenstrass
gs	gs
gsa	gsa
gsdc	gsdc
gsell	gsell
gsf	gsf
gsg	gsg
gsh	gsh
gslv	gslv
gsm	gsm
gsmbh	gsmbh
gss	gss
gsse	gsse
gstaad	gstaad
gsv	gsv
gt	gt
gte	gte
gto	gto
gtz	gtz
gu	gu
guaceto	guaceto
guadaganto	guadaganto
guadaganva	guadaganva
guadagar	guadagar
guadagn	guadagn
guadagna	guadagn
guadagnamo	guadagnamo
guadagnando	guadagnando
guadagnandon	guadagnando
guadagnandosi	guadagnandosi
guadagnano	guadagnano
guadagnar	guadagnar
guadagnarci	guadagnarci
guadagnarebb	guadagnarebb
guadagnarl	guadagnarl
guadagnarlo	guadagnarl
guadagnarn	guadagnar
guadagnarsi	guadagnarsi
guadagnass	guadagnass
guadagnata	guadagnat
guadagnati	guadagnat
guadagnato	guadagnat
guadagnatosi	guadagnatosi
guadagnava	guadagnava
guadagnavano	guadagnavano
guadagner	guadagner
guadagnerabb	guadagnerabb
guadagneranno	guadagneranno
guadagnerebb	guadagnerebb
guadagnerebbero	guadagnerebbero
guadagneremmo	guadagneremmo
guadagneret	guadagneret
guadagnerà	guadagner
guadagnerò	guadagner
guadagni	guadagn
guadagnino	guadagnino
guadagno	guadagn
guadagnò	guadagn
guadagrar	guadagrar
guadaira	guadaira
guadalajara	guadalajara
guadalup	guadalup
guadalupa	guadalup
guadarrama	guadarrama
guadavano	guadavano
guadia	guadia
guadiacost	guadiacost
guadiana	guadiana
guado	guado
guai	guai
guaina	guaina
guaio	guaio
guair	guair
guaira	guair
guaiti	guaiti
guaiva	guaiva
guajardo	guajardo
guajiro	guajiro
gualberto	gualberto
gualdi	gualdi
gualtieri	gualtier
gualtiero	gualtier
guam	guam
guanabo	guanabo
guanajato	guanajato
guanajuato	guanajuato
guanc	guanc
guancia	guancia
guanda	guanda
guandong	guandong
guangdong	guangdong
guanglin	guanglin
guangm	guangm
guangsheng	guangsheng
guangxi	guangxi
guangyi	guangyi
guangyun	guangyun
guangzhou	guangzhou
guangzhu	guangzhu
guanodong	guanodong
guanshan	guanshan
guant	guant
guantaia	guantaia
guantanamera	guantanamera
guantanamno	guantanamno
guantanamo	guantanamo
guanti	guant
guanto	guant
guantoni	guantoni
guanxi	guanxi
guar	guar
guarai	guarai
guarante	guarant
guaranti	guarant
guaranà	guaran
guaranì	guaran
guard	guard
guarda	guarda
guardabascio	guardabascio
guardaboschi	guardaboschi
guardacaso	guardacaso
guardacost	guardacost
guardamagna	guardamagna
guardami	guardami
guardando	guardando
guardandola	guardandola
guardandosi	guardandosi
guardano	guardano
guardapesca	guardapesca
guardar	guarda
guardarail	guardarail
guardarla	guardarl
guardarlo	guardarl
guardarmi	guardarmi
guardaroba	guardaroba
guardarsi	guardarsi
guardasigilli	guardasigilli
guardaspal	guardaspal
guardass	guardass
guardat	guardat
guardata	guardat
guardatela	guardatela
guardatemi	guardatemi
guardati	guardat
guardatina	guardatina
guardato	guardat
guardava	guardav
guardavano	guardavano
guardavo	guardav
guardea	guardea
guarderanno	guarderanno
guarderebbero	guarderebbero
guarderemo	guarderemo
guarderà	guarderà
guardi	guardi
guardia	guardi
guardiaboschi	guardiaboschi
guardiacost	guardiacost
guardiamo	guardiamo
guardian	guardian
guardiana	guardian
guardiani	guardian
guardiano	guardian
guardiaparchi	guardiaparchi
guardiaparco	guardiaparco
guardiaspal	guardiaspal
guardina	guardin
guardinga	guardinga
guardinghi	guardinghi
guardino	guardin
guardinà	guardin
guardià	guardi
guardo	guard
guardon	guardon
guardonesch	guardonesch
guardoni	guardon
guardrail	guardrail
guardò	guard
guaren	guaren
guarendo	guarendo
guaribil	guaribil
guaribili	guaribil
guarigion	guarigion
guarija	guarija
guarino	guarino
guarir	guarir
guarirli	guarirli
guarirà	guarir
guarirò	guarir
guarisc	guarisc
guarisci	guarisc
guarit	guarit
guarita	guarit
guariti	guarit
guarito	guarit
guaritor	guaritor
guaritori	guaritor
guaritric	guaritric
guarnigion	guarnigion
guarnigioni	guarnigion
guarnigiuoni	guarnigiuoni
guarnito	guarnito
guarnizioni	guarnizioni
guarr	guarr
guarranti	guarranti
guarà	guarà
guarì	guarì
guasconata	guasconata
guasta	guasta
guastafest	guastafest
guastalla	guastalla
guastano	guastano
guastar	guasta
guastarono	guastarono
guastat	guastat
guastata	guastat
guastato	guastat
guastator	guastator
guastatori	guastator
guastatosi	guastatosi
guastava	guastava
guasti	guast
guasto	guast
guatamaltechi	guatamaltechi
guatamela	guatamela
guatemala	guatemala
guatemalteca	guatemaltec
guatemaltech	guatemaltech
guatemaltechi	guatemaltech
guatemalteco	guatemaltec
guaya	guaya
guayabero	guayabero
guayana	guayana
guayaquil	guayaquil
guazzabuglio	guazzabuglio
guazzaroni	guazzaroni
guazzelli	guazzelli
guazzi	guazzi
guba	guba
gubbio	gubbio
guben	guben
guber	guber
gubetti	gubetti
gubler	gubler
gubser	gubser
gucci	gucci
guccion	guccion
gudauta	gudauta
guddryat	guddryat
guderm	guderm
gudermersh	gudermersh
gudic	gudic
gudicata	gudicata
gudjarat	gudjarat
gudo	gudo
gudoum	gudoum
gudrat	gudrat
gudrun	gudrun
gue	gue
guebuza	guebuza
guechguech	guechguech
guecho	guecho
gued	gued
guee	guee
gueffroi	gueffroi
gueidar	gueidar
guel	guel
guelaat	guelaat
guelfa	guelfa
guelil	guelil
guella	guella
guelma	guelma
guelmar	guelma
guemazi	guemazi
guemmar	guemmar
guemmazi	guemmazi
guendalina	guendalina
guenichot	guenichot
guenifi	guenifi
guenter	guenter
guenther	guenther
guepièr	guepièr
guera	guera
guerassov	guerassov
guerdi	guerdi
guerdia	guerdi
gueret	gueret
gueriglia	gueriglia
gueriglieri	gueriglieri
guerillero	guerillero
guerin	guerin
guernica	guernica
guerr	guerr
guerra	guerr
guerrafondai	guerrafondai
guerrafondaia	guerrafondai
guerrafondaio	guerrafondai
guerreggiata	guerreggiata
guerreglieri	guerreglieri
guerrero	guerrero
guerresch	guerresch
guerrexo	guerrexo
guerrier	guerrier
guerriera	guerrier
guerrieri	guerrier
guerriero	guerrier
guerrigleri	guerrigleri
guerrigli	guerrigli
guerriglia	guerrigli
guerriglier	guerriglier
guerrigliera	guerriglier
guerriglieri	guerriglier
guerrigliero	guerriglier
guerrilla	guerrilla
guerrillera	guerrillera
guerrista	guerrist
guerristi	guerrist
guerristì	guerrist
guerrra	guerrra
guerrriglieri	guerrriglieri
guerrà	guerr
guess	guess
guest	guest
guestrow	guestrow
guetersloh	guetersloh
guevara	guevara
guevarista	guevarista
guey	guey
guezireh	guezireh
guezou	guezou
gufan	gufan
gufi	gufi
gug	gug
gugelmann	gugelmann
gugerel	gugerel
gugerti	gugerti
guggehheim	guggehheim
guggenbichl	guggenbichl
guggenbühl	guggenbühl
guggenheim	guggenheim
guggenmusik	guggenmusik
gugger	gugger
guglemann	guglemann
gugler	gugler
gugli	gugli
guglielmetti	guglielmetti
guglielmina	guglielmina
guglielmo	guglielmo
guglielo	guglielo
gugliemina	gugliemina
gugliemo	gugliemo
gugliotta	gugliotta
guguletu	guguletu
guguli	guguli
gui	gui
guia	guia
guiana	guiana
guibal	guibal
guicciardini	guicciardini
guichard	guichard
guichet	guichet
guichi	guichi
guid	guid
guida	guida
guidabilità	guidabilità
guidamolla	guidamolla
guidando	guidando
guidano	guidan
guidant	guidan
guidar	guida
guidarl	guidarl
guidarla	guidarl
guidarli	guidarl
guidarlo	guidarl
guidarlì	guidarl
guidarono	guidarono
guidass	guidass
guidat	guidat
guidata	guidat
guidatelo	guidatelo
guidati	guidat
guidato	guidat
guidator	guidator
guidatori	guidator
guidatrici	guidatrici
guidava	guidav
guidavano	guidavano
guidavo	guidav
guideranno	guideranno
guiderei	guiderei
guiderà	guider
guiderò	guider
guidi	guidi
guidiamo	guidiamo
guidic	guidic
guidicelli	guidicelli
guidici	guidic
guidinetti	guidinetti
guidino	guidino
guidiziari	guidiziari
guidiziaria	guidiziari
guido	guido
guidolin	guidolin
guidà	guidà
guidò	guidò
guierrier	guierrier
guigou	guigou
guiidar	guiidar
guild	guild
guildhal	guildhal
guilherm	guilherm
guilin	guilin
guillaum	guillaum
guillemin	guillemin
guiller	guiller
guillermo	guillermo
guillerne	guillerne
guillier	guillier
guillman	guillman
guillottin	guillottin
guillouz	guillouz
guillouzu	guillouz
guiluo	guiluo
guilvinec	guilvinec
guimara	guimara
guin	guin
guinand	guinand
guinea	guinea
guineana	guinean
guineano	guinean
guineiani	guineiani
guiness	guiness
guinier	guinier
guinn	guinn
guinzagli	guinzagli
guinzaglio	guinzagli
guinzburg	guinzburg
guir	guir
guiren	guiren
guisan	guisan
guiso	guiso
guitarrista	guitarrista
guitoun	guitoun
guitri	guitri
guitti	guitti
guitton	guitton
guiuan	guiuan
guiyang	guiyang
guizendan	guizendan
guizhou	guizhou
guizzavano	guizzavano
guizzo	guizzo
gujarat	gujarat
gujrat	gujrat
gukasian	gukasian
gukelberg	gukelberg
gukovo	gukovo
gul	gul
gula	gula
gulag	gulag
gulandri	gulandri
gulash	gulash
gulbahar	gulbahar
gulbani	gulbani
gulbuddin	gulbuddin
gulbudin	gulbudin
guld	guld
gule	gule
gulf	gulf
gulfport	gulfport
gulfstream	gulfstream
guliano	guliano
guliev	guliev
gulino	gulino
gulitsa	gulitsa
gulli	gulli
gullickson	gullickson
gullit	gulli
gulliv	gulli
gullstrand	gullstrand
gulotta	gulotta
gulu	gulu
gulua	gulua
gulyev	gulyev
gum	gum
gumar	gumar
gumhureya	gumhureya
gumhuria	gumhuria
gumhuriya	gumhuriya
gumi	gumi
gumiel	gumiel
gumisi	gumisi
gummer	gummer
gummibaerelen	gummibaerelen
gump	gump
gun	gun
gunatillek	gunatillek
gunato	gunato
gundelding	gundelding
gundem	gundem
gunei	gunei
gunen	gunen
guneratn	guneratn
gunhil	gunhil
gunhild	gunhil
gunilla	gunilla
gunma	gunma
gunn	gunn
gunna	gunna
gunnarson	gunnarson
gunner	gunne
gunnet	gunne
gunnilla	gunnilla
gunten	gunten
gunter	gunter
guntern	gunter
gunther	gunther
gunti	gunti
guntin	gunti
guntram	guntram
gunzgen	gunzgen
gunzing	gunzing
guo	guo
guofan	guofan
guofang	guofan
guop	guop
guoq	guoq
guoqi	guoqi
guoqiang	guoqiang
guotao	guotao
gup	gup
guppo	guppo
gupta	gupta
gur	gur
guradia	guradia
guradiani	guradiani
gurdia	gurdia
gurdjeff	gurdjeff
gure	gure
gureghian	gureghian
gurev	gurev
guri	guri
guribil	guribil
gurin	gurin
gurinov	gurinov
gurion	gurion
gurit	gurit
gurlei	gurlei
gurra	gurra
gurriglia	gurriglia
gurten	gurten
gurtnellen	gurtnellen
gurtner	gurtner
guru	guru
gurzel	gurzel
gurzelngass	gurzelngass
gusci	gusci
guscio	gusci
guscott	guscott
guseinov	guseinov
gusev	gusev
gush	gush
gushiegu	gushiegu
gusinov	gusinov
gusmao	gusmao
gusmi	gusmi
gustando	gustando
gustar	gustar
gustars	gustar
gustato	gustato
gustav	gustav
gustava	gustav
gustavo	gustav
gusti	gusti
gusto	gusto
gustos	gustos
gustosa	gustos
gustosament	gustosament
gustosi	gustos
gustoso	gustos
gut	gut
gute	gute
gutema	gutema
gutenberg	gutenberg
guterr	guterr
gutgeheissen	gutgeheissen
guthri	guthri
gutierrez	gutierrez
gutknecht	gutknecht
gutman	gutman
gutmann	gutman
gutta	gutta
guttadauro	guttadauro
guttamch	guttamch
gutti	gutti
guttmach	guttmach
gutturali	gutturali
guttuso	guttuso
gutzeit	gutzeit
gutzwil	gutzwil
guuggenmusigen	guuggenmusigen
guwahati	guwahati
guyana	guyana
guyer	guyer
guyerzel	guyerzel
guyot	guyot
guzman	guzman
guzzi	guzzi
gvero	gvero
gwala	gwala
gwang	gwang
gwe	gwe
gwen	gwen
gweru	gweru
gwinner	gwinner
gwyneth	gwyneth
gyalcan	gyalcan
gyarmati	gyarmati
gyaw	gyaw
gyger	gyger
gygi	gygi
gyldend	gyldend
gyldenkild	gyldenkild
gyli	gyli
gyll	gyll
gyoengyo	gyoengyo
gyoergi	gyoergi
gyor	gyor
gyorgi	gyorgi
gyorko	gyorko
gypsi	gypsi
gyr	gyr
gyseni	gyseni
gysenyi	gysenyi
gyshita	gyshita
gysi	gysi
gysin	gysin
gysl	gysl
gyst	gyst
gyuerra	gyuerra
gyula	gyula
györgi	györgi
gzb	gzb
gäfgen	gäfgen
gähwiler	gähwiler
gäu	gäu
générale	générale
génération	génération
géo	géo
géographiqu	géographiqu
gérald	gérald
géraldin	géraldin
gérard	gérard
géza	géza
göbbel	göbbel
göbel	göbel
göhner	göhner
gök	gök
göncz	göncz
görard	görard
göschenen	göschenen
gösgen	gösgen
göteborg	göteborg
göthe	göthe
götte	götte
göttin	göttin
götze	götze
gùud	gùud
gübler	gübler
gügler	gügler
gümligen	gümligen
gümlingen	gümlingen
gündelhart	gündelhart
gündem	gündem
güntensperg	güntensperg
günter	günter
günthardt	günthardt
günther	günther
gürbe	gürbe
güterumschéaggruopp	güterumschéaggruopp
güttigen	güttigen
güttingen	güttingen
h1n1	h1n1
h2	h2
h2o	h2o
h3n2	h3n2
haa	haa
haad	haad
haag	haag
haak	haak
haakon	haakon
haamidia	haamidia
haan	haan
haannunciato	haannunciato
haanticipato	haanticipato
haarder	haarder
haaret	haaret
haaretz	haaret
haarezt	haarezt
haarlem	haarlem
haas	haas
haaton	haaton
haavelmo	haavelmo
haavisto	haavisto
hab	hab
haba	haba
habaniy	habaniy
habariyama	habariyama
habash	habash
habbad	habba
habbakuk	habbakuk
habbash	habbash
habbaz	habba
habboush	habboush
habdoun	habdoun
habea	habea
habena	habena
haber	haber
haberfeld	haberfeld
habersaat	habersaat
habgood	habgood
habi	habi
habiaryama	habiaryama
habiarymana	habiarymana
habib	habib
habibi	habib
habibur	habibur
habil	habil
habimana	habimana
habimeza	habimeza
habineza	habineza
habitat	habitat
habito	habito
habitué	habitué
hablar	hablar
hablood	hablood
hablützel	hablützel
habouci	habouci
habr	habr
habsburg	habsburg
habyarima	habyarima
habyarimana	habyarimana
hacen	hacen
hach	hach
hachachta	hachachta
hachani	hachani
hachemi	hachemi
hachett	hachett
hachijoji	hachijoji
hachimia	hachimia
hachinoh	hachinoh
hachioji	hachioji
hacin	hacin
hack	hack
hackensack	hackensack
hacker	hacker
hackett	hackett
hackettstown	hackettstown
hackman	hackman
hackmann	hackman
hacknei	hacknei
hacohen	hacohen
hacommentato	hacommentato
haconvocato	haconvocato
hada	hada
hadaeq	hadaeq
hadam	hadam
hadar	hadar
hadash	hadas
hadass	hadas
hadassa	hadassa
hadassah	hadassa
hadatha	hadatha
haddad	hadda
haddadi	haddadi
haddadin	haddadi
haddam	hadda
hadeciso	hadeciso
hadeln	hadeln
hadenham	hadenham
hader	hader
hadera	hader
haderi	hader
haderri	haderri
hadethi	hadethi
hadetto	hadetto
hadfield	hadfield
hadi	hadi
hadia	hadia
hadichiarato	hadichiarato
hadid	hadid
hadit	hadit
hadith	hadit
hadj	hadj
hadja	hadja
hadjadi	hadjadi
hadjal	hadja
hadjar	hadja
hadjeb	hadjeb
hadjut	hadjut
hadle	hadle
hadlei	hadle
hadleigh	hadleigh
hadramaout	hadramaout
hadramat	hadramat
hadramaut	hadramaut
hadramawt	hadramawt
hadrami	hadrami
hadramout	hadramout
hadron	hadron
hadzic	hadzic
hadzici	hadzic
haeakatul	haeakatul
haef	haef
haeflig	haeflig
haefner	haefner
haegi	haegi
haeju	haeju
haekkerup	haekkerup
haelg	haelg
haellstrom	haellstrom
haemophilu	haemophilu
haendel	haendel
haensch	haensch
haer	haer
haerter	haerter
haesortato	haesortato
haespresso	haespresso
haessig	haessig
haetzni	haetzni
hafar	hafar
hafeez	hafeez
hafer	hafer
hafez	hafez
haffeje	haffeje
hafid	hafid
hafiz	hafiz
hafizullah	hafizullah
haflig	haflig
hafling	hafling
hafner	hafner
hafno	hafno
haft	haft
hafteh	hafteh
hag	hag
haga	haga
hagag	hagag
hagai	hagai
hagakol	hagakol
hagan	hagan
hageman	hageman
hagemann	hageman
hagen	hagen
hager	hager
hagga	hagga
haggag	hagga
haggai	hagga
haggakol	haggakol
hagi	hagi
hagsten	hagsten
hagu	hagu
hahmad	hahmad
hahn	hahn
hahnlos	hahnlos
haho	haho
haiber	haiber
haid	haid
haidar	haidar
haidegg	haidegg
haider	haider
haidian	haidian
haidid	haidid
haifa	haifa
haig	haig
haigh	haigh
haignorato	haignorato
haik	haik
haikman	haikman
haiko	haiko
haikstep	haikstep
hail	hail
hailei	hailei
hailé	hailé
haim	haim
haimovitz	haimovitz
hain	hain
hainan	hainan
haindicato	haindicato
hainewald	hainewald
haini	haini
hainrich	hainrich
haiphong	haiphong
hair	hair
hairui	hairui
haisu	haisu
hait	hait
haitani	haitani
haitham	haitha
haithan	haitha
haithem	haithem
haiti	haiti
haitian	haitian
haitiana	haitian
haitiani	haitian
haitiano	haitian
haitien	haitien
haitienn	haitien
haitiiano	haitiiano
haitinai	haitinai
haitiniano	haitiniano
haito	haito
haj	haj
hajatolesman	hajatolesman
hajdarev	hajdarev
haji	haji
hajiabad	hajiabad
hajim	hajim
hajj	hajj
hajredin	hajredin
hajrudin	hajrudin
hajrula	hajrula
hak	hak
hakam	hakam
hakan	hakan
hakata	hakata
hakawati	hakawati
hakim	hakim
hakkari	hakkari
hakki	hakki
hakkinen	hakkinen
hakmoun	hakmoun
hakuran	hakuran
hal	hal
halabi	halabi
halabja	halabja
halacha	halach
halachà	halach
halaf	halaf
halaib	halaib
halaleh	halaleh
halamera	halamera
halauca	halauca
halawani	halawani
halbach	halbach
halberstam	halberstam
halbertsam	halbertsam
halbwax	halbwax
halcli	halcli
halda	halda
haldemann	haldemann
haldengut	haldengut
haldimann	haldimann
hale	hale
halei	halei
halen	halen
halesworth	halesworth
halet	halet
halevi	halevi
half	half
halfa	halfa
halfond	halfond
halgreen	halgreen
halgrin	halgrin
halhoul	halhoul
halhul	halhul
hali	hali
halibut	halibut
halicz	halicz
halifax	halifa
halifaz	halifa
halil	halil
halilopici	halilopici
halim	halim
halima	halim
haliti	haliti
halkali	halkali
halko	halko
hall	hall
halla	halla
hallak	halla
hallandal	hallandal
halldor	halldor
hallei	hallei
hallein	hallei
hallelujah	hallelujah
hallenspach	hallenspach
hallenstadion	hallenstadion
haller	haller
hallgarth	hallgarth
halli	halli
hallidai	hallidai
hallier	hallier
hallion	hallion
hallist	hallist
hallo	hallo
hallowai	hallowai
halloween	halloween
hallowéen	hallowéen
hallwag	hallwag
hallwil	hallwil
hallwylstrass	hallwylstrass
hallydai	hallydai
halmahera	halmahera
halmstad	halmstad
halner	halner
halo	halo
haloun	haloun
halperin	halperin
halphen	halphen
halsal	halsal
halsel	halse
halser	halse
halt	halt
halter	halter
haluk	haluk
halybarton	halybarton
halyburton	halyburton
ham	ham
hama	hama
hamach	hamach
hamad	hamad
hamada	hamada
hamadan	hamada
hamadi	hamad
hamahan	hamahan
hamaid	hamaid
hamam	hamam
hamami	hamam
hamamoto	hamamoto
hamana	haman
hamann	haman
hamaoka	hamaoka
hamasiko	hamasiko
hamayotsu	hamayotsu
hambach	hambach
hambatota	hambatota
hambest	hambest
hambl	hambl
hamblei	hamblei
hamburg	hamburg
hamburgh	hamburg
hamchahri	hamchahr
hamchahrì	hamchahr
hamdam	hamda
hamdan	hamda
hamden	hamden
hamdi	hamdi
hamdija	hamdija
hamdiya	hamdiya
hamdoom	hamdoo
hamdoon	hamdoo
hamdoun	hamdoun
hame	hame
hameida	hameida
hamel	hamel
hamelin	hamelin
hamer	hamer
hamerman	hamerman
hami	hami
hamid	hamid
hamida	hamid
hamidreza	hamidreza
hamieda	hamieda
hamil	hamil
hamilton	hamilton
hamington	hamington
hamish	hamish
hamishmar	hamishmar
hamlet	hamlet
hamli	hamli
hamlon	hamlon
hamm	hamm
hammad	hammad
hammadi	hammad
hammam	hammam
hammamet	hammamet
hammami	hammam
hamman	hamman
hammarsjoeld	hammarsjoeld
hammer	hammer
hammerschmidt	hammerschmidt
hammersmith	hammersmith
hammerstein	hammerstein
hammond	hammond
hammoud	hammoud
hammound	hammound
hammourabi	hammourabi
hammud	hammud
hamnet	hamnet
hamodia	hamodia
hamoyotsu	hamoyotsu
hampshir	hampshir
hampson	hampson
hampton	hampton
hamra	hamra
hamsa	hamsa
hamshahri	hamshahri
hamshari	hamshari
hamshir	hamshir
hamu	hamu
hamutenya	hamutenya
hamza	hamza
hamzeh	hamzeh
han	han
hana	hana
hanaa	hanaa
hanafi	hanafi
hanako	hanako
hanan	hanan
hanau	hanau
hanausek	hanausek
hanbno	hanbno
hanc	hanc
hancock	hancock
hancu	hancu
hand	hand
handal	handal
handel	handel
handelsbank	handelsbank
handelsblatt	handelsblatt
handelstag	handelstag
handelszeitung	handelszeitung
handeslbank	handeslbank
handi	handi
handicap	handicap
handicapp	handicap
handicappata	handicappat
handicappati	handicappat
handicappato	handicappat
handiccapati	handiccapati
handl	handl
handlei	handlei
handlowi	handlowi
handrickson	handrickson
handuk	handuk
handwörterbuch	handwörterbuch
haneda	haneda
hanf	hanf
hanford	hanford
hanfplu	hanfplu
hang	hang
hangar	hangar
hanger	hanger
hanggi	hanggi
hangzhou	hangzhou
hanhart	hanhart
hani	hani
hanib	hanib
hanif	hanif
hanifia	hanifia
hanin	hanin
hanina	hanin
hanisch	hanisch
hanjin	hanjin
hanjung	hanjung
hank	hank
hanko	hanko
hanlei	hanlei
hanlon	hanlon
hanmaat	hanmaat
hanmoud	hanmoud
hann	hann
hanna	hanna
hannah	hanna
hannai	hanna
hannan	hanna
hannawalt	hannawalt
hannel	hannel
hannelor	hannelor
hanni	hanni
hannibalssen	hannibalssen
hannibalsson	hannibalsson
hannic	hannic
hannich	hannic
hannno	hannno
hannodovuto	hannodovuto
hannoi	hanno
hannon	hanno
hannoprovocato	hannoprovocato
hannoricevuto	hannoricevuto
hannoricordato	hannoricordato
hannoscandito	hannoscandito
hannoun	hannoun
hannov	hanno
hannoverificato	hannoverificato
hannoversch	hannoversch
hannp	hannp
hannriportato	hannriportato
hannukah	hannukah
hannunciato	hannunciato
hano	hano
hanoch	hanoch
hanoi	hanoi
hanoï	hanoï
hanp	hanp
hansa	hansa
hansch	hansch
hansen	hansen
hansenn	hansen
hanser	hanser
hansgeorg	hansgeorg
hansguenth	hansguenth
hansh	hansh
hansheiri	hansheiri
hansjakob	hansjakob
hansjoerg	hansjoerg
hansjörg	hansjörg
hansjürg	hansjürg
hansohn	hansohn
hanson	hanson
hanspet	hanspet
hansruedi	hansruedi
hanstholm	hanstholm
hansu	hansu
hansuedi	hansuedi
hanswlat	hanswlat
hantan	hantan
hantaviru	hantaviru
hantj	hantj
hanun	hanun
hanya	hanya
hanyeh	hanyeh
hao	hao
haoji	haoji
haotian	haotian
haouch	haouch
haouchin	haouchin
hapala	hapala
hapoalim	hapoalim
happen	happen
happi	happi
hapresentato	hapresentato
hapreso	hapreso
haq	haq
haqqani	haqqani
har	har
harada	harada
harago	harago
haraigu	haraigu
haraka	haraka
harakabi	harakabi
harakat	haraka
harakatul	harakatul
harakiri	harakiri
haralamb	haralamb
harald	harald
haram	haram
haramboulo	haramboulo
harar	harar
harari	harar
harass	harass
harat	harat
haravghi	haravghi
harayana	harayana
harb	harb
harba	harba
harbel	harbel
harbin	harbin
harbor	harbor
harbour	harbour
harchoun	harchoun
harcourt	harcourt
hard	hard
hardaga	hardaga
hardcor	hardcor
harde	harde
hardesti	hardesti
hardi	hardi
hardin	hardi
hardlin	hardlin
hardraht	hardraht
hardrock	hardrock
hardtum	hardtum
hardturm	hardturm
hardturmstrass	hardturmstrass
hardwar	hardwar
hare	hare
haredì	haredì
harefield	harefield
harel	harel
harem	harem
hareplicato	hareplicato
haresh	haresh
hareth	hareth
harfa	harfa
harford	harford
hargeisa	hargeisa
hargreav	hargreav
hargrov	hargrov
hari	hari
haridi	haridi
harijan	harijan
harimproverato	harimproverato
haringse	haringse
harion	harion
hariri	hariri
harisa	haris
harish	haris
harisposto	harisposto
harkabi	harkabi
harkan	harka
harkat	harka
harket	harket
harki	harki
harkin	harki
harlan	harlan
harland	harlan
harlei	harle
harlem	harle
harlequin	harlequin
harm	harm
harman	harman
harmein	harmein
harmer	harmer
harmoni	harmoni
harmoza	harmoza
harmut	harmut
harnoncourt	harnoncourt
harod	harod
harold	harold
harp	harp
harpaz	harpaz
harper	harper
harpercollin	harpercollin
harpia	harpia
harpiya	harpiya
harpoon	harpoon
harrach	harrach
harrani	harrani
harrel	harrel
harrelson	harrelson
harri	harri
harrier	harrie
harriet	harrie
harriman	harriman
harringen	harringen
harrington	harrington
harrismith	harrismith
harrison	harrison
harrod	harro
harrog	harro
harsanyi	harsanyi
harsh	harsh
harsham	harsham
hart	hart
hartarto	hartarto
harteh	harteh
hartfield	hartfield
hartford	hartford
harti	harti
hartl	hartl
hartlei	hartlei
hartman	hartman
hartmann	hartman
hartmut	hartmut
hartsfield	hartsfield
hartzenberg	hartzenberg
harufumi	harufumi
harumi	harumi
haruo	haruo
harvard	harvard
harvei	harvei
harvest	harvest
harvé	harvé
harwann	harwann
harward	harward
harwich	harwich
harwit	harwit
haryana	haryana
harz	harz
harza	harza
harzenberg	harzenberg
hasa	hasa
hasan	hasan
hasangegov	hasangegov
hasanguliev	hasanguliev
hasbro	hasbro
hascemi	hascemi
hascemita	hascemita
haschisch	haschisch
haschish	haschish
haschk	haschk
hascic	hascic
hascihsch	hascihsch
hascisc	hascisc
hascisch	hascisc
hascish	hascish
hasco	hasco
haseck	haseck
hasegawa	hasegawa
haseki	haseki
hasen	hasen
hasenfratz	hasenfratz
hashanah	hashanah
hasharon	hasharon
hashem	hashem
hashemi	hashem
hashemieh	hashemieh
hashemita	hashemita
hashemiyah	hashemiyah
hashi	hashi
hashimi	hashimi
hashimoto	hashimoto
hashisc	hashisc
hashisch	hashisc
hashish	hashish
hashmieh	hashmieh
hashom	hashom
hasina	hasina
hasisc	hasisc
haskamp	haskamp
haskil	haskil
hasl	hasl
hasler	hasler
hasni	hasni
haspeso	haspeso
hass	hass
hassaba	hassaba
hassad	hassa
hassain	hassain
hassan	hassa
hassanat	hassanat
hassanein	hassanein
hasselhoff	hasselhoff
hasselt	hasselt
hassi	hassi
hassib	hassi
hassidica	hassidic
hassidich	hassidic
hassidici	hassidic
hassidim	hassidim
hassin	hassi
hast	hast
hasuperati	hasuperati
hat	hat
hata	hata
hatakeyama	hatakeyama
hatanaka	hatanaka
hatawai	hatawai
hatem	hatem
hathawai	hathawai
hathor	hathor
hatip	hatip
hato	hato
hatoyama	hatoyama
hatsidaki	hatsidaki
hatt	hatt
hatta	hatta
hattab	hatta
hau	hau
hauenstein	hauenstein
haug	haug
haugaard	haugaard
haugen	haugen
haugestad	haugestad
haugova	haugova
hauk	hauk
haul	haul
hauma	hauma
haumà	haumà
haupl	haupl
haupt	haupt
hauptabteilung	hauptabteilung
hauptbahnhofstrass	hauptbahnhofstrass
haupverwaltung	haupverwaltung
hauri	hauri
haus	haus
hauser	hauser
hausgaard	hausgaard
hauskencht	hauskencht
hausknecht	hausknecht
hausman	hausman
haussa	haussa
haussmann	haussmann
haustechnik	haustechnik
haut	haut
hauzenberg	hauzenberg
hava	hava
havaii	havaii
havana	havana
havard	havard
havel	havel
havelaar	havelaar
havelock	havelock
havemann	havemann
haven	haven
haverford	haverford
havik	havik
havilland	havilland
havnen	havnen
havr	havr
havrix	havrix
haw	haw
hawa	hawa
hawad	hawad
hawadhl	hawadhl
hawadl	hawad
hawai	hawai
hawaian	hawaian
hawaiana	hawaian
hawaii	hawai
hawaiian	hawaiian
hawaiiani	hawaiian
hawali	hawali
hawara	hawara
hawash	hawash
hawatmeh	hawatmeh
hawiy	hawiy
hawk	hawk
hawker	hawker
hawkin	hawkin
hawkslei	hawkslei
haworth	haworth
hawthorn	hawthorn
hawyard	hawyard
hawyi	hawyi
hay	hay
haya	haya
hayain	hayain
hayami	hayami
hayashi	hayashi
hayat	hayat
hayatabad	hayatabad
hayatolesman	hayatolesman
haydarpasa	haydarpasa
hayden	hayde
hayder	hayde
haydn	haydn
hayek	hayek
hayer	hayer
hayeshuà	hayeshuà
hayhurst	hayhurst
haymo	haymo
haymoz	haymo
hayward	hayward
haywood	haywood
hayyat	hayyat
hazair	hazair
hazal	hazal
hazani	hazani
hazara	hazar
hazard	hazar
hazarika	hazarika
hazbar	hazbar
hazd	hazd
hazel	hazel
hazelwood	hazelwood
hazem	hazem
hazen	hazen
hazim	hazim
hazinda	hazinda
hazleton	hazleton
hazrabt	hazrabt
hazrat	hazrat
hazratb	hazrat
haïdouk	haïdouk
hb	hb
hbo	hbo
hbyarimana	hbyarimana
hc	hc
hca	hca
hcb	hcb
hce	hce
hcg	hcg
hcph	hcph
hcr	hcr
hcv	hcv
hd	hd
hde	hde
hdk	hdk
hdl	hdl
hdtv	hdtv
hdz	hdz
hea	hea
head	head
headi	headi
headquart	headquart
heal	heal
heali	heali
health	health
healthcar	healthcar
healthtrust	healthtrust
heanei	heanei
hear	hear
heard	heard
hearnei	hearnei
hearst	hearst
heart	heart
hearth	heart
hearther	hearther
hearthquak	hearthquak
heartmat	heartmat
heat	heat
heath	heath
heathcoat	heathcoat
heather	heather
heatherwood	heatherwood
heathrow	heathrow
heathtrow	heathtrow
heatrhow	heatrhow
heaven	heaven
heavenli	heavenli
heavent	heaven
heavi	heavi
hebdo	hebdo
hebe	hebe
hebei	hebei
heberlein	heberlein
hebo	hebo
hebollah	hebollah
hebraica	hebraica
hebron	hebron
hebronp	hebron
hebutern	hebutern
hec	hec
hecht	hecht
heckmann	heckmann
hector	hector
hedd	hedd
hedegaard	hedegaard
hedera	hedera
hedg	hedg
hedgar	hedgar
hedgehog	hedgehog
hedi	hedi
hedig	hedig
heding	heding
hedland	hedland
hedman	hedman
hedon	hedon
hedramaut	hedramaut
hedrick	hedrick
hee	hee
heeb	heeb
heemskerk	heemskerk
heep	heep
heer	heer
heerbrugg	heerbrugg
heerden	heerden
hefenhofen	hefenhofen
hefetz	hefetz
hefner	hefner
hefti	hefti
hegazi	hegazi
hegel	hegel
heger	heger
hegetschweil	hegetschweil
heggenberg	heggenberg
hegibach	hegibach
hegner	hegner
hei	hei
heiberg	heiberg
heid	heid
heidelberg	heidelberg
heidemari	heidemari
heiden	heide
heidenheim	heidenheim
heider	heide
heidi	heidi
heidiland	heidiland
heidorn	heidorn
heidrun	heidrun
heiga	heiga
height	height
heigth	heigth
heiichi	heiichi
heik	heik
heikal	heikal
heiki	heiki
heikki	heikki
heiko	heiko
heil	heil
heilan	heilan
heilbronn	heilbronn
heilbrunn	heilbrunn
heildeberg	heildeberg
heiliggeistkirch	heiliggeistkirch
heilmet	heilmet
heilongjiang	heilongjiang
heilonjiang	heilonjiang
heilsin	heilsin
heiluan	heiluan
heim	heim
heiman	heiman
heimatbund	heimatbund
heimatschutz	heimatschutz
heimgartn	heimgartn
heimiswil	heimiswil
hein	hein
heineken	heineken
heinemann	heinemann
heiner	heiner
heini	heini
heinig	heini
heink	heink
heinrich	heinric
heinrici	heinric
heinrik	heinrik
heinz	heinz
heinzelmann	heinzelmann
heinzenberg	heinzenberg
heipl	heipl
heiri	heiri
heis	heis
heiser	heiser
heisterberg	heisterberg
heiter	heiter
heitmann	heitmann
heitzir	heitzir
heiz	heiz
heizmann	heizmann
hekamtyar	hekamtyar
hekesi	hekesi
hekmat	hekmat
hekmatiar	hekmatiar
hekmatyar	hekmatyar
hekmayar	hekmayar
hekuran	hekuran
hela	hela
helaleya	helaleya
held	held
heldenplatz	heldenplatz
helder	helder
helen	helen
helena	helen
heletz	heletz
helevg	helevg
helez	helez
helfen	helfen
helg	helg
helga	helga
helgoland	helgoland
helgrit	helgrit
heli	heli
helicobact	helicobact
helicopt	helicopt
helinton	helinton
helio	helio
heliopoli	heliopoli
heliski	heliski
helksinki	helksinki
hell	hell
hella	hella
hellabrunn	hellabrunn
hellam	hella
hellawel	hellawel
hellbühl	hellbühl
hellen	helle
heller	helle
hellersdorf	hellersdorf
hellikon	hellikon
helling	helling
hellinikon	hellinikon
hello	hello
hellstroem	hellstroem
hellweg	hellweg
helm	helm
helmhau	helmhau
helmslei	helmslei
helmut	helmut
helmuth	helmut
helongjiang	helongjiang
helou	helou
heloué	helou
help	help
helplin	helplin
hels	hels
helsingin	helsingin
helsinki	helsinki
helu	helu
heluan	heluan
helumt	helumt
helveg	helveg
helvesat	helvesat
helveta	helveta
helvetia	helvetia
helvetiaplatz	helvetiaplatz
helvetica	helvetica
helveticat	helvetica
helveticum	helveticum
helvéthèqu	helvéthèqu
helweh	helweh
helyett	helyett
helù	helù
hem	hem
hemacar	hemacar
hemant	hemant
hemayel	hemayel
hemberg	hemberg
hemberto	hemberto
hemeida	hemeida
hemingwai	hemingwai
hemispher	hemispher
hemkatyar	hemkatyar
hemmi	hemmi
hemp	hemp
hemut	hemut
hen	hen
henan	henan
henday	henday
hendel	hendel
henderson	henderson
hendi	hendi
hendrick	hendrick
hendricks	hendrick
hendrik	hendrik
hendriks	hendrik
hendrix	hendrix
hengameh	hengameh
henger	henger
henggao	henggao
henggel	henggel
hengstenberg	hengstenberg
hengyang	hengyang
henieb	henieb
henk	henk
henkel	henkel
henneken	henneken
hennequin	hennequin
henner	henner
hennessi	hennessi
henni	henni
henniez	henniez
hennig	henni
hennigsdorf	hennigsdorf
henningen	henningen
henningfield	henningfield
henningsdorf	henningsdorf
henri	henri
henrich	henric
henrici	henric
henrick	henric
henriett	henriett
henrik	henri
henriot	henriot
henriqu	henriqu
henryk	henryk
hensch	hensch
henschel	henschel
hensel	hensel
hensinki	hensinki
henson	henson
hentsch	hentsch
hep	hep
hepburn	hepburn
heppel	heppel
hepso	hepso
hera	hera
heracl	heracl
herakl	herakl
heraklion	heraklion
heralambi	heralambi
herald	herald
herat	herat
herb	herb
herbert	herbert
herberto	herbert
herbi	herbi
herbon	herbon
herbst	herbst
herceg	herceg
herchen	herchen
hercul	hercul
herczog	herczog
herd	herd
herdahl	herdahl
herdal	herdal
here	here
hereford	hereford
herek	herek
heren	heren
herfken	herfken
herford	herford
herger	herger
hergiswil	hergiswil
heribert	heribert
herich	herich
herickson	herickson
heriot	heriot
heriqu	heriqu
herisau	herisau
heritag	heritag
herkenrath	herkenrath
herkuman	herkuman
herlitz	herlitz
herloev	herloev
herm	herm
herman	herman
hermann	herman
hermanvil	hermanvil
herminio	herminio
hermitag	hermitag
hermlin	hermlin
hermogen	hermogen
hermon	hermon
hermosillo	hermosillo
hermoza	hermoza
hernan	hernan
hernandez	hernandez
hernani	hernan
herni	herni
hernst	hernst
hernu	hernu
hero	hero
heroin	heroin
herold	herold
heronvid	heronvid
herouvillett	herouvillett
herp	herp
herr	herr
herraga	herraga
herranz	herranz
herren	herren
herrera	herrera
herri	herri
herriot	herriot
herrliberg	herrliberg
herrman	herrman
herrmann	herrman
herrnstein	herrnstein
herro	herro
herrscht	herrscht
hersant	hersant
hersh	hersh
hershad	hershad
hershei	hershei
hersi	hersi
herstedvest	herstedvest
herta	herta
herteman	herteman
hertford	hertford
hertfordshir	hertfordshir
herti	herti
hertig	herti
hertl	hertl
hertreit	hertreit
hertz	hertz
hertzenberg	hertzenberg
hertziana	hertziana
herv	herv
hervé	hervé
herzan	herzan
herzberg	herzberg
herzeg	herzeg
herzegovina	herzegovina
herzlya	herzlya
herzog	herzog
herzogenbuchse	herzogenbuchse
herzogenrath	herzogenrath
herzé	herzé
heré	heré
hesan	hesan
heseltin	heseltin
heskin	heskin
heslop	heslo
heslot	heslo
hesoun	hesoun
hess	hess
hessen	hessen
hessich	hessich
hesso	hesso
hesta	hesta
heston	heston
hetendorf	hetendorf
heterosygma	heterosygma
hetet	hetet
hetex	hetex
hetrick	hetrick
hetzel	hetze
hetzer	hetze
heubach	heubach
heuer	heuer
heugten	heugten
heur	heur
heureka	heureka
heuss	heuss
heusser	heusser
heustrich	heustrich
heuzé	heuzé
hev	hev
hevea	hevea
hever	hever
hevetica	hevetica
heweluisz	heweluisz
hewitt	hewitt
hewlett	hewlett
hewson	hewson
hey	hey
heydar	heydar
heyder	heyder
heyek	heyek
heyerdahl	heyerdahl
heyken	heyken
heym	heym
heyman	heyman
heymann	heyman
heyr	heyr
heysel	heysel
heysham	heysham
heyward	heyward
hezb	hezb
hezbolla	hezbolla
hezbollah	hezbolla
hezekiah	hezekiah
hezobllah	hezobllah
hf	hf
hhi	hhi
hi	hi
hiadana	hiadana
hiag	hiag
hiatt	hiatt
hib	hib
hibakusha	hibakusha
hibiscu	hibiscu
hibraim	hibraim
hic	hic
hicham	hicham
hichem	hichem
hick	hick
hickei	hicke
hickel	hicke
hickl	hickl
hickman	hickman
hidaka	hidaka
hidalgo	hidalgo
hide	hide
hideaki	hideaki
hidechika	hidechika
hideo	hideo
hideshi	hideshi
hidetoshi	hidetoshi
hidiart	hidiart
hidipo	hidipo
hidjab	hidjab
hidjazi	hidjazi
hidroelektra	hidroelektra
hidroirma	hidroirma
hieb	hieb
hiedi	hiedi
hieng	hieng
hier	hier
hierro	hierro
hiesl	hiesl
higazi	higazi
higelin	higelin
higg	higg
higgin	higgin
high	high
higham	higham
higher	higher
highgrov	highgrov
highland	highland
highlei	highlei
highsmith	highsmith
hight	hight
highwai	highwai
higinio	higinio
higino	higino
higra	higra
higton	higton
higuchi	higuchi
higuei	higuei
higushi	higushi
hihi	hihi
hija	hija
hijab	hijab
hijeh	hijeh
hijja	hijja
hijleh	hijleh
hikasa	hikasa
hikkaduwa	hikkaduwa
hikmat	hikmat
hikmet	hikmet
hilal	hilal
hilaui	hilaui
hilberg	hilberg
hilbig	hilbig
hild	hild
hilda	hilda
hildbrand	hildbrand
hildebrandt	hildebrandt
hildegard	hildegard
hilden	hilden
hilemon	hilemon
hilf	hilf
hilfer	hilfer
hilfsverein	hilfsverein
hilger	hilger
hill	hill
hilla	hilla
hillal	hilla
hillari	hillari
hillaryg	hillaryg
hillebrand	hillebrand
hiller	hiller
hilli	hilli
hillier	hillier
hillman	hillman
hillsdown	hillsdown
hilma	hilma
hilmar	hilma
hilshir	hilshir
hilsman	hilsman
hiltbrunn	hiltbrunn
hilti	hilti
hilton	hilton
hiltrud	hiltrud
hilw	hilw
hilweh	hilweh
hilwé	hilwé
himaalayan	himaalayan
himach	himach
himalaja	himalaja
himalaya	himalaya
himalayan	himalayan
himalayana	himalayan
himalayani	himalayan
himalayano	himalayan
himmel	himmel
himmelreich	himmelreich
himmler	himmler
himst	himst
hin	hin
hina	hina
hinayana	hinayana
hinblick	hinblick
hincklei	hincklei
hind	hind
hindawi	hindawi
hindelbank	hindelbank
hindenburg	hindenburg
hindi	hindi
hindlbank	hindlbank
hindson	hindson
hindu	hindu
hinduja	hinduja
hindustan	hindustan
hindù	hindù
hine	hine
hinici	hinici
hinmen	hinmen
hinniyeh	hinniyeh
hinter	hinter
hintergründ	hintergründ
hinterim	hinterim
hinterland	hinterland
hintermann	hintermann
hinterrhein	hinterrhein
hinton	hinton
hintz	hintz
hinwil	hinwil
hiostrah	hiostrah
hip	hip
hiperostosi	hiperostosi
hipp	hipp
hippeau	hippeau
hippi	hippi
hippidion	hippidion
hippidum	hippidum
hippo	hippo
hirab	hirab
hiraiwa	hiraiwa
hiraklion	hiraklion
hiram	hiram
hiran	hiran
hiraoka	hiraoka
hirata	hirata
hire	hire
hirech	hirech
hirlap	hirlap
hirnant	hirnant
hirni	hirni
hirofumi	hirofumi
hirogumi	hirogumi
hirohisa	hirohisa
hirohito	hirohito
hironaka	hironaka
hiros	hiros
hiroshi	hiroshi
hiroshima	hiroshima
hiroto	hiroto
hiroyuki	hiroyuki
hirsch	hirsch
hirschi	hirsch
hirsh	hirsh
hirshfeld	hirshfeld
hirst	hirst
hirt	hirt
hirzel	hirzel
hisar	hisar
hisashi	hisashi
hisch	hisch
hisham	hisham
hispaniola	hispaniola
hispano	hispano
hispasat	hispasat
hissam	hissa
hissar	hissa
hissoua	hissoua
hissua	hissua
histadrut	histadrut
histadruth	histadrut
hister	hister
histoir	histoir
histor	histor
histori	histori
historia	histori
historiqu	historiqu
hiswah	hiswah
hit	hit
hitachi	hitachi
hitch	hitch
hitchcock	hitchcock
hitchen	hitchen
hitchock	hitchock
hitchocok	hitchocok
hite	hite
hitimana	hitimana
hitimara	hitimara
hitler	hitler
hitleriana	hitlerian
hitleriani	hitlerian
hitleriano	hitlerian
hitlerismo	hitlerismo
hitoshi	hitoshi
hitotsubashi	hitotsubashi
hitz	hitz
hiv	hiv
hivar	hivar
hiverlet	hiverlet
hivid	hivid
hiwa	hiwa
hiwar	hiwar
hizb	hizb
hizzian	hizzian
hjelm	hjelm
hjemmevaernet	hjemmevaernet
hjordi	hjordi
hjort	hjort
hla	hla
hlahel	hlahel
hlasek	hlasek
hlh	hlh
hlm	hlm
hm	hm
hmeid	hmeid
hmidi	hmidi
hmlh1	hmlh1
hmo	hmo
hmoud	hmoud
hn	hn
hnd	hnd
hnein	hnein
hnhcr	hnhcr
hnno	hnno
hoa	hoa
hoan	hoan
hoang	hoang
hoar	hoar
hobart	hobart
hobbema	hobbema
hobbi	hobbi
hobbisti	hobbisti
hobbit	hobbi
hobeika	hobeika
hoboken	hoboken
hobro	hobro
hobson	hobson
hoc	hoc
hoca	hoca
hoceima	hoceima
hoch	hoch
hochalp	hochalp
hochdeutsch	hochdeutsch
hochfeld	hochfeld
hochhout	hochhout
hochhuth	hochhuth
hochkoenig	hochkoenig
hochschul	hochschul
hochtief	hochtief
hochuli	hochuli
hocin	hocin
hock	hock
hockei	hockei
hockeistica	hockeistica
hockri	hockri
hocké	hocké
hod	hod
hoda	hoda
hodeibi	hodeibi
hodeida	hodeida
hodeidah	hodeida
hodg	hodg
hodgink	hodgink
hodgkin	hodgkin
hodgman	hodgman
hodgson	hodgson
hodjak	hodjak
hodjatoleslam	hodjatoleslam
hodl	hodl
hodler	hodler
hodscha	hodscha
hodzic	hodzic
hoechst	hoechst
hoechstadt	hoechstadt
hoecker	hoecker
hoefel	hoefel
hoeffel	hoeffel
hoeflig	hoeflig
hoehm	hoehm
hoehn	hoehn
hoelev	hoelev
hoelig	hoelig
hoeneck	hoeneck
hoenlein	hoenlein
hoeppner	hoeppner
hoerster	hoerster
hoesch	hoesch
hoeydahl	hoeydahl
hoeynck	hoeynck
hoeynk	hoeynk
hof	hof
hofbauer	hofbauer
hofburg	hofburg
hofel	hofel
hofer	hofer
hoffa	hoffa
hoffenberg	hoffenberg
hoffman	hoffman
hoffmann	hoffman
hoffmey	hoffmey
hofgastein	hofgastein
hofheim	hofheim
hofl	hofl
hofmann	hofmann
hofmannsth	hofmannsth
hofmeist	hofmeist
hofstett	hofstett
hogan	hogan
hogard	hogard
hogarth	hogarth
hogberg	hogberg
hoger	hoger
hogg	hogg
hogref	hogref
hogstadeu	hogstadeu
hogu	hogu
hohe	hohe
hohenau	hohenau
hohenloh	hohenloh
hohenschönhausen	hohenschönhausen
hohenzollern	hohenzollern
hohl	hohl
hohler	hohler
hohlstrass	hohlstrass
hohman	hohman
hoi	hoi
hojatoleslam	hojatoleslam
hojatoleslman	hojatoleslman
hojatolislam	hojatolislam
hojin	hojin
hokkaido	hokkaido
hokusai	hokusai
holan	holan
holbrook	holbrook
holcomb	holcomb
hold	hold
holden	holde
holder	holde
holderbank	holderbank
holdernak	holdernak
holdig	holdi
holdin	holdi
hole	hole
holenstein	holenstein
holger	holger
holguin	holguin
holick	holick
holid	holid
holidai	holidai
holighau	holighau
holing	holing
holl	holl
holland	holland
hollanda	holland
hollenstein	hollenstein
holler	holler
holli	holli
hollidai	hollidai
hollig	holli
hollingworth	hollingworth
hollist	hollist
holliwood	holliwood
hollowai	hollowai
hollstein	hollstein
hollweg	hollweg
hollydai	hollydai
hollywood	hollywood
hollywoodian	hollywoodian
hollywoodiana	hollywoodian
hollywoodiani	hollywoodian
hollywoodiano	hollywoodian
hollywwod	hollywwod
holländer	holländer
holm	holm
holocaust	holocaust
holomisa	holomisa
holon	holon
holovati	holovati
holst	holst
holstein	holstein
holstyn	holstyn
holt	holt
holtmann	holtmann
holton	holton
holtzbrinck	holtzbrinck
holtzendorff	holtzendorff
holum	holum
holvi	holvi
holydai	holydai
holyfield	holyfield
holyhead	holyhead
holzherr	holzherr
holzhäus	holzhäus
holzig	holzig
holziken	holziken
holzing	holzing
holzman	holzman
holzmann	holzman
holzstoff	holzstoff
homa	homa
homberg	homberg
hombourg	hombourg
home	home
homecar	homecar
homeland	homeland
homeless	homeless
homem	homem
homen	homen
homero	homero
homestead	homestead
homini	homini
homm	homm
hommu	hommu
homo	homo
hon	hon
honak	honak
honarbakhsh	honarbakhsh
hond	hond
honda	honda
hondura	hondura
honduregna	honduregn
honduregni	honduregn
honeck	honeck
honegg	honegg
honei	honei
honein	honei
honek	honek
honeywel	honeywel
honfleur	honfleur
hong	hong
hongb	hongb
hongbin	hongbin
hongkong	hongkong
hongkonghesi	hongkonghesi
hongmin	hongmin
hongo	hongo
hongp	hongp
hongqi	hongqi
hongrin	hongrin
hongyan	hongyan
honk	honk
honnef	honne
honneg	honne
honni	honni
honolulu	honolulu
honor	honor
honorem	honorem
honori	honor
honorum	honorum
honoré	honor
honour	honour
honshu	honshu
honsi	honsi
honsik	honsi
hood	hood
hoodoo	hoodoo
hool	hool
hooligan	hooligan
hooliwood	hooliwood
hoop	hoop
hooper	hooper
hoot	hoot
hooter	hooter
hoover	hoover
hop	hop
hopa	hopa
hope	hope
hopewel	hopewel
hopf	hopf
hopkin	hopkin
hopman	hopman
hopp	hopp
hopper	hopper
hora	hora
horac	horac
horacio	horacio
horber	horber
horbin	horbin
horenbout	horenbout
horgen	horgen
hori	hori
horia	horia
horin	horin
horinek	horinek
horizon	horizon
horizont	horizon
horkheim	horkheim
hormat	hormat
hormel	hormel
hormiga	hormiga
hormiguita	hormiguita
hormuz	hormuz
hormuzgan	hormuzgan
horn	horn
horner	horner
hornlund	hornlund
horno	horno
horo	horo
horodyski	horodyski
horologèr	horologèr
horoscop	horoscop
horowitz	horowitz
horramshahr	horramshahr
horribili	horribili
horror	horror
hors	hors
horsch	horsch
horsemen	horsemen
horsman	horsman
horst	horst
hort	hort
horta	horta
horten	horten
horton	horton
horvat	horvat
horvitz	horvitz
horw	horw
hosakawa	hosakawa
hosang	hosang
hosen	hosen
hosni	hosni
hosokawa	hosokawa
hospent	hospent
hospit	hospit
hospodarsk	hospodarsk
hoss	hoss
hossam	hossam
hossein	hossein
hosseineh	hosseineh
hosseini	hossein
hossfeld	hossfeld
host	host
hostess	hostess
hostettl	hostettl
hosto	hosto
hosyar	hosyar
hot	hot
hotaikainen	hotaikainen
hoteg	hoteg
hotel	hotel
hotelplan	hotelplan
hotelzug	hotelzug
hoten	hoten
hotlin	hotlin
hotschnig	hotschnig
hotting	hotting
hottingen	hottingen
hotz	hotz
hou	hou
houari	houari
houck	houck
houdain	houdain
houdini	houdini
houdon	houdon
hough	hough
houghton	houghton
houla	houla
houna	houna
hounah	houna
hounslow	hounslow
houphouet	houphouet
houphouët	houphouët
hour	hour
hourcad	hourcad
hourghada	hourghada
houriet	houriet
hous	hous
housego	housego
housekeep	housekeep
housepian	housepian
housman	housman
houssekin	houssekin
housselik	housselik
houston	houston
houthalen	houthalen
hove	hove
hoveni	hoveni
hovercraft	hovercraft
hovsepian	hovsepian
how	how
howald	howald
howard	howard
howeg	howeg
howeida	howeida
howel	howel
howen	howen
howland	howland
howlin	howlin
howrath	howrath
hoxa	hoxa
hoxha	hoxha
hoybeck	hoybeck
hoyer	hoyer
hoyerswerda	hoyerswerda
hoyl	hoyl
hoyo	hoyo
hoyr	hoyr
hoz	hoz
hozier	hozier
hp	hp
hpt	hpt
hpv	hpv
hr	hr
hrabal	hrabal
hrant	hrant
hraoui	hraoui
hrasnica	hrasnica
hrasnitsa	hrasnitsa
hrawi	hrawi
hrawr	hrawr
hrc	hrc
hresa	hresa
hrh	hrh
hrinak	hrinak
hripsimé	hripsimé
hristophor	hristophor
hrnjic	hrnjic
hrovatin	hrovatin
hrvoje	hrvoje
hrw	hrw
hs	hs
hsbc	hsbc
hse	hse
hsiao	hsiao
hsien	hsien
hsing	hsing
hsinshu	hsinshu
hsl	hsl
hsp	hsp
hsu	hsu
ht	ht
htlv	htlv
htun	htun
htv	htv
hu	hu
hua	hua
huacana	huacana
hualien	hualien
huallaga	huallaga
huallcor	huallcor
huambo	huambo
huanaco	huanaco
huancavelica	huancavelica
huancayo	huancayo
huang	huang
huangbeip	huangbeip
huangcuo	huangcuo
huangmei	huangmei
huangshi	huangshi
huangti	huangti
huanta	huanta
huanuco	huanuco
huaq	huaq
huaqiang	huaqiang
huaqiu	huaqiu
huaqui	huaqui
huaraz	huaraz
huard	huard
huasco	huasco
huastec	huastec
huayascachi	huayascachi
huayu	huayu
huazhong	huazhong
hub	hub
hubach	hubach
hubballah	hubballah
hubbard	hubbar
hubbart	hubbar
hubbel	hubbel
hubbert	hubbert
hubbl	hubbl
hubei	hubei
huber	huber
hubert	hubert
hubertu	hubert
hubmann	hubmann
hubner	hubner
huck	huck
huckepack	huckepack
hudal	hudal
hudding	hudding
huddleston	huddleston
hudson	hudson
hudsuck	hudsuck
hue	hue
huebner	huebner
huefner	huefner
huegel	huegel
huei	huei
huejotzingo	huejotzingo
huelsenbeck	huelsenbeck
huen	huen
huenx	huenx
huerta	huerta
huettenwerk	huettenwerk
hueva	hueva
huez	huez
huffington	huffington
hufschmid	hufschmid
hufvudstadsbladet	hufvudstadsbladet
hug	hug
huge	huge
hugemi	hugemi
huggenberg	huggenberg
hugget	hugget
hugh	hugh
hugher	hugher
hugo	hugo
hugong	hugong
hugonot	hugonot
hugu	hugu
huguenin	huguenin
huguett	huguett
huhuetenango	huhuetenango
hui	hui
huila	huila
huillich	huillich
huixean	huixean
huixian	huixian
huizenga	huizenga
huizi	huizi
hukov	hukov
hula	hula
hull	hull
hulm	hulm
hulond	hulond
huls	huls
hultgreen	hultgreen
hulul	hulul
hulun	hulun
hulusi	hulusi
huma	huma
human	human
humana	human
humanit	humanit
humanitair	humanitair
humanitarian	humanitarian
humanité	humanit
humanum	humanum
humayn	humayn
humayun	humayun
humbel	humbel
humbershid	humbershid
humbersid	humbersid
humberto	humberto
humbl	humbl
humblei	humblei
humboldt	humboldt
hume	hume
humer	humer
humet	humet
hummadi	hummadi
hummel	hummel
hummingbird	hummingbird
humnert	humnert
humo	humo
humor	humor
humoud	humou
humour	humou
humphrei	humphrei
humphri	humphri
hun	hun
huna	huna
hunan	hunan
hundt	hundt
hung	hung
hungaria	hungaria
hungarian	hungaria
hungarista	hungarista
hungri	hungri
hunguana	hunguana
huningu	huningu
hunkel	hunkel
hunnicutt	hunnicutt
hunt	hunt
hunter	hunter
huntigton	huntigton
huntington	huntington
huntsvil	huntsvil
hunyadi	hunyadi
hunzik	hunzik
huo	huo
huot	huot
huozh	huozh
hupac	hupac
huppert	huppert
huppi	huppi
huq	huq
hural	hural
hurani	hurani
hurayrah	hurayrah
hurd	hurd
hurden	hurden
hurgada	hurgada
hurghada	hurghada
hurl	hurl
hurlei	hurlei
hurlimann	hurlimann
hurlston	hurlston
hurmouziadi	hurmouziadi
hurni	hurni
hurra	hurra
hurriyet	hurriyet
hurrà	hurrà
hurst	hurst
hurt	hurt
hurtado	hurtado
hurton	hurton
hurwitz	hurwitz
husa	husa
husain	husain
husak	husak
husamettin	husamettin
husan	husan
husanov	husanov
husar	husar
huschk	huschk
husein	husein
huseinov	huseinov
huseyin	huseyin
husic	husic
husing	husing
huska	huska
hussa	hussa
hussain	hussain
hussam	hussa
hussaynoun	hussaynoun
husseain	husseain
hussein	hussein
husseini	hussein
husseinian	husseinian
husseinun	husseinun
husssein	husssein
huston	huston
hustwitt	hustwitt
hut	hut
hutch	hutch
hutchinson	hutchinson
huter	huter
huti	huti
hutter	hutter
hutton	hutton
huttwil	huttwil
hutu	hutu
hutù	hutù
huu	huu
huvendick	huvendick
huvudstadsbladet	huvudstadsbladet
huwyl	huwyl
huyen	huyen
huygu	huygu
huynh	huynh
huzhaik	huzhaik
hva	hva
hvo	hvo
hwada	hwada
hwan	hwan
hwang	hwang
hwaomkyung	hwaomkyung
hwv	hwv
hyacint	hyacint
hyacinth	hyacint
hyanni	hyanni
hyatt	hyatt
hydara	hydara
hyde	hyde
hyderabad	hyderabad
hydraulik	hydraulik
hydro	hydro
hydrocarbon	hydrocarbon
hydroelektra	hydroelektra
hydroxyzin	hydroxyzin
hye	hye
hyer	hyer
hygien	hygien
hygièn	hygièn
hykso	hykso
hyle	hyle
hylesia	hylesia
hynd	hynd
hyogo	hyogo
hyon	hyon
hyong	hyong
hyper	hyper
hypercard	hypercard
hypo	hypo
hypothekar	hypothekar
hypothekarbank	hypothekarbank
hypotheken	hypotheken
hyrtl	hyrtl
hysen	hysen
hysteria	hysteria
hyun	hyun
hyundai	hyundai
hyver	hyver
hyèr	hyèr
hzd	hzd
hzdl	hzdl
häberli	häberli
hächler	hächler
häfeli	häfeli
hägendorf	hägendorf
häggenschwil	häggenschwil
hägler	hägler
hähni	hähni
hämmerl	hämmerl
hämmerli	hämmerl
hämmig	hämmig
hänggi	hänggi
häni	häni
hänni	hänni
hänny	hänny
hänsch	hänsch
hänseberg	hänseberg
hänsenberg	hänsenberg
härkingen	härkingen
häsler	häsler
häusermann	häusermann
hébergement	hébergement
héla	héla
hélène	hélène
héléne	héléne
héren	héren
héritier	héritier
hérémenc	hérémenc
hêche	hêche
hôtel	hôtel
höchst	höchst
höhener	höhener
höhere	höhere
hölderlin	hölderlin
hölli	hölli
hölstein	hölstein
hönggerberg	hönggerberg
hönng	hönng
höpflinger	höpflinger
höppner	höppner
hörbranz	hörbranz
hörhausen	hörhausen
höri	höri
hübscher	hübscher
hühnliwald	hühnliwald
hüllen	hüllen
hünenberg	hünenberg
hünibach	hünibach
hüningen	hüningen
hüppi	hüppi
hürlimann	hürlimann
hüttligen	hüttligen
hüttlingen	hüttlingen
i993	i993
ia	ia
iaa	iaa
iaat	iaat
iab	iab
iabalo	iabalo
iabloko	iabloko
iablokov	iabloko
iacopo	iacopo
iacovelli	iacovelli
iacoviello	iacoviello
iacovu	iacovu
iacuzia	iacuzia
iadarbyev	iadarbyev
iadarola	iadarola
iaea	iaea
iaglu	iaglu
iai	iai
iaio	iaio
iakov	iakov
iakovliev	iakovliev
iakursk	iakursk
iakuzia	iakuzia
ial	ial
ialia	ialia
ialuronico	ialuronico
ialà	ialà
iam	iam
iamalo	iamalo
iamburg	iamburg
iamkun	iamkun
iamont	iamont
iampolski	iampolski
ian	ian
iana	iana
ianaiev	ianaiev
iandarbaiev	iandarbaiev
iandarbiev	iandarbiev
iandarbyev	iandarbyev
ianderbiev	ianderbiev
ianderbiv	ianderbiv
iandyrka	iandyrka
iannacci	iannacci
iannaccon	iannaccon
iannello	iannello
ianni	ianni
ianniko	ianniko